--------------------------------------------------------------------------------------------------------------------------------------------
--------------------------------------------------------------------------------------------------------------------------------------------
--------------------------------------------------------------------------------------------------------------------------------------------
--------------------------------------------------------------------------------------------------------------------------------------------
--------------------------------------------------------------------------------------------------------------------------------------------
----------SSSQQ----Q------------------------------------------------SQ----------------------------------------------------------------------
--------------------------------------------------------------------------------------------------------------------------------------------
---------E----------------------------------------------------------------------------------------------------------------------------------
--------------------------------------------------------------------------------------------------------------------------------------------
----S--S?S---------SQ----SS------------------<>-----------S-----<>-------XXS-----X-------------------XX-------------------------------------
------------------------X--------------------[]-----------------[]-------X------X-----------<>------XXX-------------------------------------
-----------------------XX--------------------[]------<>-X-------[]-----X-X-----XX---X-------[]------XXX-----------<>-------------<>-------<>
-E-----------EEEE---E--EXX--------------E----[]-------E-E--E--E-[]----XXXX----XXXX--B-EE----[]-----XXXX-----------[]-------------[]X------[]
XXXXXXXXXXXXXXXXXXXXXXXXXXXXXXXXXXXXXXXXXXXXXXXXXXXXXXXXXXXXXXXXXXXXXXXXXXXXXXXXXXX-XXXXXXXXXXXXXXXXXXXXXXXXXXXXXXXX--XXX-----XXXX-XXXXXXXXX