--------------------------------------------------------------------------------------------------------------------------------------------
--------------------------------------------------------------------------------------------------------------------------------------------
--------------------------------------------------------------------------------------------------------------------------------------------
--------------------------------------------------------------------------------------------------------------------------------------------
--------------------------------------------------------------------------------------------------------------------------------------------
SSS---SS-----------------------------SSSSQQ----Q---------------------Q--------------S--------SSSQS----SQ-------X----------------------------
------------------------------------------------------X-------------------------------------------------------------------------------------
--------------------------------------------------------------------------------------------------------------------------------------------
-----------------------------------------------------XX-------------------------------------------------------------------------------------
--------------S----X---------Q--Q--SSS---------S----XXX----S-------S?S---<>--------S----Q--SS----------S------------------------------------
--------------------------------------------------XXXX-------------------[]--------------------------------XX--X---?--------------XX--------
-------------------XX-----<>----------------------XXXX----<>-------------[]--------------------------------XX--X--<>---<>--------XXX--------
----------EE---X---XXX-----o-E-----------EEEEE--E-XXXX--E-[]--------E-E--[]-------E--------------E-E-E--E-EXXX-X--[]---[]-------XXXX--------
X-XXXXXXX-XXXXXXX--XXXXXXXXXXXXXXXXXXXXXXXXXXXXXXXXXXXX-XXXXXXXXXXXXXXXXXXXXXXXXXXXXXXXXXXXXXXXXXXXXXXXXXXXXXXXXXXXXXXXXXXXXX-XXXXXXXXXXXXXX