--------------------------------------------------------------------------------------------------------------------------------------------
--------------------------------------------------------------------------------------------------------------------------------------------
--------------------------------------------------------------------------------------------------------------------------------------------
--------------------------------------------------------------------------------------------------------------------------------------------
--------------------------------------------------------------------------------------------------------------------------------------------
-------------------------------------------------------------------------------------------------Q--------------------------SSS----Q-------S
--------------------------------------------------------------------------------------------------------------------------------------------
---------------------------------------------------------------------------------------------------------------------------E----------------
--------------------------------------------------------------------------------------------------------------------------------------------
-----------------<>--------------------------XX---------------------?S----------------<>-------S------S--Q--Q-SSQ--Q--Q--S?--------SS----SS-
-----------------[]------<>----S----<>-------XX---------------------------------------[]----------------------------------------------------
--------<>-------[]------[]---<>----[]------XXX-----------<>-------------<>-----------[]----<>----------------------------------------------
E-------[]-------[]-----X[]---[]----[]------XXX-----------[]--------E----[]-----------[]----[]----E---E--E--------------------E-E---EE-E----
XXXXXXXXXXXXXXXXXXXXXXXXXXXXXXXXXXXXXXXXXXXXXXXXXXXXXXXXXXXXXXXXXXXXXXXXXXXXXXXXXXXXXXXXXXXXXXXXXXXXXXXXXXXXXXXXXXXXXXXXXXXXXXXXXXXXXXXXXXXX