--------------------------------------------------------------------------------------------------------------------------------------------
--------------------------------------------------------------------------------------------------------------------------------------------
--------------------------------------------------------------------------------------------------------------------------------------------
--------------------------------------------------------------------------------------------------------------------------------------------
--------------------------------------------------------------------------------------------------------------------------------------------
--SSSSSS--------SSQ-----------SSS------------------------------------Q-------------------------------Q-----------SSSSSS---------------------
--------------------------------------------------------------------------------------------------------------------------------------------
--------------------------------------------------------------------------------------------------------------------------------------------
--------------------------------------------------------------------------------------------------------------------------------------------
--------------S------------------------X--X-X--X-----------SS----S?S-S----S--Q--QSSS------------QSQ-----------------------------------------
---------------------------------------X--XX---XX-------------------------------------------------------------------------------------------
-------------------X------<>-------<>-XX--XXX--XXX-----<>-----------------------------------------------------<>----------------------------
-------<>-EE-------X------[]-------[]XXX-XXXX--XXXX----[]-------------E-E-E--E--------------------------------[]----------------------------
XXXXXXXXXXXXXXXXXXXXXXXXXXXX--XXXXXXXXXXXXXXXXXXXXXXXXXXXXXXXXXXXXXXXXXXXXXXXXXXXXXXXXXXX--XXXXXXXXXXXX-XXXXXXXX--XX----X-------XX----XXXXXX