--------------------------------------------------------------------------------------------------------------------------------------------
--------------------------------------------------------------------------------------------------------------------------------------------
--------------------------------------------------------------------------------------------------------------------------------------------
--------------------------------------------------------------------------------------------------------------------------------------------
--------------------------------------------------------------------------------------------------------------------------------------------
--------------------------------------------------------------------------------------------------S-----------------------------------------
--------------------------------------------------------------------------------------------------------------------------------------------
--------------------------------------------------------------------------------------------------------------------------------------------
--------------------------------------------------------------------------------------------------------------------------------------------
-------<>-------X--XX---------------------X----X---------------------------------------S-------S?S----S--Q-----Q---------------------SS-----
-------[]-----XXX--XXX-----------------X--XX---XX---------------------------------------------------------------X------------------X--------
-------[]-----XXX--XXX-----<>------<>-XX---XX--XX-----<>--<>----<>-------<>-------------------------------------X------<>--------XXX--------
---E-E-[]-E--XXXXX-XXXX----[]------[]XXX---XX-XXXX----[]--[]----[]-------[]-------------------------E-E-------E---E----[]X------XXXX--------
XXXXXXXXXXXXXXXXXXXXXXXXXXXX---XXXXXXXXX--XXXX-XXXXXXXXXXXXXXXXXXXXXXXXXXXXXXXXXXXXXXXXXXXXXXXXXXXXXXXXXXXXXXXXXXXXXXXXXXXXX----XXXXXXXXXXXX