--------------------------------------------------------------------------------------------------------------------------------------------
--------------------------------------------------------------------------------------------------------------------------------------------
--------------------------------------------------------------------------------------------------------------------------------------------
--------------------------------------------------------------------------------------------------------------------------------------------
--------------------------------------------------------------------------------------------------------------------------------------------
-------------Q--------------------------SQS---------------------------------------------------S-SSQ----Q---SSS---SSSSSSS----SSSSSSSSS---S---
--------------------------------------------------------------------------------------------------------------------------------------------
---------------------------------------E-----------------------------------------------------E----------------------------------------------
--------------------------------------------------------------------------------------------------------------------------------------------
Q----------S------S------SS-S--Q-----S?S------S--Q--QSSQ-------------------------------SS--S?S---------SS---------------------SS------------
--<>----------------------------------------------------X------------------X----------------------------------------------------------------
--[]------------------------------------------------------<>---<>----------XX--------------------------------------------------------------B
--[]----------E-E-E--E-E------------------E-E-E--E--------[]---[]----------XXX-------------------E-EE---E--E-E-E--------------------------<>
XXXXXXXXXXXXXXXXXXXXXXXXXXXXXXXXXXXXXXXXXXXXXXXXXXXXXXXX--XX--XX-------------------XXXXXXXXXXXXXXXXXXXXXXXXXXXXXXXXXXXXXXXXXXXXXXXXXXXXXXXXX