--------------------------------------------------------------------------------------------------------------------------------------------
--------------------------------------------------------------------------------------------------------------------------------------------
--------------------------------------------------------------------------------------------------------------------------------------------
--------------------------------------------------------------------------------------------------------------------------------------------
--------------------------------------------------------------------------------------------------------------------------------------------
--------------SSSSSSS--SSSSS----------------------------S---------SSSS------------SS--------------------------------------------------------
--------------------------------------------------------------------------------------------------------------------------------------------
--------------------------------------------------------------------------------E-----------------------------------------------------------
--------------------------------------------------------------------------------------------------------------------------------------------
--------------SS-----------------------------<>----------------SS-----S-----S-S?S--------------S?S----B--Q-----S-----------SQS----Q--Q--Q--Q
-------------------------------Q-------------[]------------------------------------------------------[]-------------------------------------
------------------------------<>----<>-------[]---------------------------------------<>-------------<>-----------<>------------------------
---------------------------E--[]----[]--E----[]----------------------E-E-------E------[]--------E-------------E---[]--------E-----E---------
XXXXXXX--XXXXXXXXXX---XXXXXXXXXXXXXXXXXXXXXXXXXXXXXXXXXXXXXXXXXXXXXXXXXXXXXXXXXXXXXXXXXXXXXXXXXXXXXXXXXXXXXXXXXXXXXXXXXXXXXXXXXXXXXXXXXXXXXX