--------------------------------------------------------------------------------------------------------------------------------------------
--------------------------------------------------------------------------------------------------------------------------------------------
--------------------------------------------------------------------------------------------------------------------------------------------
--------------------------------------------------------------------------------------------------------------------------------------------
--------------------------------------------------------------------------------------------------------------------------------------------
---------SS-S---------------SS----SS---SQ----------------------------Q-------------------------------------------QQ---S---------------------
--------------------------------------------------------------------------------------------------------------------------------------------
--------------------------------------------------------------------------------------------------------------------------------------------
--------------------------------------------------------------------------------------------------------------------------------------------
-SS-S---SB---------S-----X---------------------X-----------B-------S------S-------SS-----------S?S---<>--QS-Q--SX-------------SS----S-S-----
------------------------X-----------------XX---XX----------Q---------------------------E-------------[]-------------------------------------
-----------------------XX-----------------XXX--XXX--------<>------------------------X-<>----<>-------<>-------------------------------------
-E------------EEEE-----XXX-------------E-XXXX--XXXX-------[]--------E-E-E-E--E----E-E-[]----[]--E----[]-------------------------------------
XXXXXXXXXXXXXXXXXXXXXXXXXXXXXXXXXXXXXXXXXXXXXXXXXXXXXXXXXXXXXXXXXXXXXXXXXXXXXXXXXXXXXXXXXXXXXXXXXXXXXXXXXXXXXXXXXXXXXXX--XXXXXXXXXXXXXXXXXXX