--------------------------------------------------------------------------------------------------------------------------------------------
--------------------------------------------------------------------------------------------------------------------------------------------
--------------------------------------------------------------------------------------------------------------------------------------------
--------------------------------------------------------------------------------------------------------------------------------------------
--------------------------------------------------------------------------------------------------------------------------------------------
-------------Q---------------QSS--------------------------------------------------------------SSSSQ----Q-------SS-----?S--------SSSSS-------
--------------------------------------------------------------------------------------------------------------------------------------------
-----------E---------------------------------------------------------------------------------E----------------------------------------------
--------------------------------------------------------------------------------------------------------------------------------------------
-SSSS----b-S------SS-----SS---------------------------------------------------S------S--S--S?S---------SS--------------SS-----SS----------<>
---------B-------------------------------------------<>----------------XX--X--------------------------------------------------------------XX
--------<>-------------XX--------------------<>------[]X--------X------XXXXX--------------------------------------------------------------XX
E-E-----[]----E-E-E----E-X-------------------[]-----XXXX-------<>-----XXXXXX---------------------E-EE---E--E-E-E--------------------E-E-EXXX
XXXXXXXXXXXXXXXXXXXXXXXXXXXXXXXX---XXXXXXXXXXXXXXXXXXXXXXXXXXXXXXXXXXXXXXXXXXXXXXXXXXXXXXXXXXXXXXXXXXXXXXXXXXXXXXXXXXXXXXXXXXXXXXXXXXXXXXXXX