--------------------------------------------------------------------------------------------------------------------------------------------
--------------------------------------------------------------------------------------------------------------------------------------------
--------------------------------------------------------------------------------------------------------------------------------------------
--------------------------------------------------------------------------------------------------------------------------------------------
--------------------------------E-----------------------------------------------------------------------------------------------------------
---------SSSQQ------------SS-SSSSSSS---------Q-----------------------------------------------S?-----------------------------------------Q---
---------------------------------------------------------------------------------------------------------------X----------------------------
------------------------E--------------------------------------------------X----------------------------------XX----------------------------
--------------------------------------------------------------------------X----------------------------------XXX----------------------------
--------SE---------S---XX-----------------S--------------SS----<>--------XX-XX-------Q--Q--QS-Q-----------XX-XXXQ--Q-------SQS----Q--Q--Q--Q
--------<>-------------XX--------------------------------------[]-------XXX-XX----------------------X----XXX-XXX----------------------------
---------------------XX-------------------------------<>X------[]------XXXX--X---XB----------------XX----XXXXXXX----------------------------
-E----E--B---EEE-E--EXXX------------------------------[]<>-E-E-[]-----XXXXX---X-XXX--E-----E---E-EXX----XXXXXXXX---E--------------E--E------
XXXXXXXXXXXXXXXXXXXXXXXXXXXX--XXXXX-----XXX--------XX-XXXXXXXXXXXXXXXXXXXXXXXXXXXXXXXXXXXXXXXXXXXXXXXXXXXXXXXXXXXXXXXXXXXXXXXXXXXXXXXXXXXXXX