--------------------------------------------------------------------------------------------------------------------------------------------
--------------------------------------------------------------------------------------------------------------------------------------------
--------------------------------------------------------------------------------------------------------------------------------------------
--------------------------------------------------------------------------------------------------------------------------------------------
--------------------------------------------------------------------------------------------------------------------------------------------
----------------------------SSSSSSSS-------------------------------------------------------------Q------------------------------------------
-------------------------------------------------------------------------X------------------------------------------------------------------
-------------------------------------------------------------------------XXX----------------------------------------------------------------
-------------------------------------------------------------------------XXXX---------------------------------------------------------------
---------------------SSQS-----------------S-------S------------<>--------XXXXX-------SSS--------------------------------------SS------------
---S-------------------------------------------X---------------[]------XXXX-XXX---X---------------------------------------------------------
--<>----<>-------------------------------------X--------X------[]------XXXXXXXX--XXX-------------------------------------------------------o
--[]----[]-----E-----------------------E---E---XX-------<>-E---[]-----XXXXXXXXX-XXXX-E------------E-E--------E-----------------------------B
XXXXXXXXXXXXXXXXXXXXXXXXXXXXXXXXXXXX--XXXXXX--XXXXXXXXXXXXXXXXXXXXXXXXXXXXXXXXXXXXXXXXXXXXXXXXXXXXXXXXXXXXXXXXXX--XXXXX-----XXXX-X---XXXXXXX