--------------------------------------------------------------------------------------------------------------------------------------------
--------------------------------------------------------------------------------------------------------------------------------------------
--------------------------------------------------------------------------------------------------------------------------------------------
--------------------------------------------------------------------------------------------------------------------------------------------
--------------------------------------------------------------------------------------------------------------------------------------------
------------------------------------------------------------SSSS--------SSSS--------------------SSS-----------------------------------------
---------------------------------------------------------------------------------------------------------------------------------X----------
---------------------------------------------------------------------------------------------------------------------------------X----------
---------------------------------------------------------------------------------------------------------------------------------X----------
-----------------<>----------SS--------------XX-----------------------SS----------<>Q--Q--Q--Q----------S---SSS--------<>-------X--XX-------
-----------------[]----------------<>-------XXX------<>---------------------------[]-----------------------------------[]------XXX-XXX------
-----------------[]------<>-X------[]-------XXX------[]---------------------------[]----------------------------X------[]-----XXXX-XXX-----o
------------E----[]------[]-<>-----[]------XXXXX----E[]---------------------------[]---E------------E----E-E-------E---[]----XXXXX-XXXX----B
XXXXXXXXXXXXXXXXXXXXXXXXXXXXXXXXXXXXXXXXXXXXXXXXXXXXXXXXXXXXXX----XXXXXXXX--XXXXXXXXXXXXXXXXXXXXXXXXXXXXXXXXXXXXXXXXXXXXXXXXXXXXXXXXXXXXXXXX