--------------------------------------------------------------------------------------------------------------------------------------------
--------------------------------------------------------------------------------------------------------------------------------------------
--------------------------------------------------------------------------------------------------------------------------------------------
--------------------------------------------------------------------------------------------------------------------------------------------
--------------------------------------------------------------------------------------------------------------------------------------------
--------------------X--------Q------------SSS------SSSQ-----------------------------------------SSS--------SQSQSSS-----S--------------------
-----------------XX-------------------------------------------------------------------------------------------------------------------------
-----------------XXXX-----------------------------------------------------------------------------------------------------------------------
-----------------XXXX-S---------------------------------------------------------------------------------------------------------------------
-----------------XXXX-------X------------SQS----------------------------------------Q--Q--Q--Q-----S----S?SQS----------Q--------------------
-------<>------XXXXXX-----------------------------------------------------------------------------------------------------------------------
X------[]------XXXXXXX------------------------------------<>------------------------------------------------------------------------------XX
---E---[]-X---XXXXXXXX------------------------------------[]-----------E---------------E------------E----E------------------------------EX<>
XXXXXXXXXXXXXXXXXXXXXXXXXXXXXXXXXX---XXXXXXXXXX--XXXXXXXXXXXXXXXXXXXXXXXXXXXXXXXXXXXXXXXXXXXXXXXXXXXXXXXXXXXXXXXXXXXXXXXXXXXXXXXXXXXXXXXXXXX