--------------------------------------------------------------------------------------------------------------------------------------------
--------------------------------------------------------------------------------------------------------------------------------------------
--------------------------------------------------------------------------------------------------------------------------------------------
--------------------------------------------------------------------------------------------------------------------------------------------
--------------------------------------------------------------------------------------------------------------------------------------------
------------SSSQ-------SSSQ--------------------------------------------------------------------------------------------------Q--------------
--------------------------------------------------------------------------------------------------------------------------------------------
-----------E--------------------------------------------------------------------------------------------------------------------------------
--------------------------------------------------------------------------------------------------------------------------------------------
---SS----S?S--------S---S----SSS--------------E--Q-----S----------------------------------------------------------<>----<>?S------S-SQ--Q--Q
---------------------------------------------[]-------------------------------------------------------------------[]----[]------------------
---------------------------------------------<>-------------------------------------------------------------------[]----[]------------------
----------------E----E---E-EE-----------E-------------------------------------------------------------------------[]----[]----E-E----E------
XXXXXXXXXXXXXXXXXXXXXXXXXXXXXXXXXXXXXXXXXXXXXXXXXXXXXXXXXXXXXXXXXXXXXXXXXXX-XXXXXXXXXXXXXXXXXXXXXXXXXXXXXXXXXXXXXXXXXXXXXXXXXXXXXXXXXXXXXXXX