--------------------------------------------------------------------------------------------------------------------------------------------
--------------------------------------------------------------------------------------------------------------------------------------------
--------------------------------------------------------------------------------------------------------------------------------------------
--------------------------------------------------------------------------------------------------------------------------------------------
--------------------------------------------------------------------------------------------------------------------------------------------
------------SSSQS------SSSQS-------------Q--------------SSQ------SSQQ-------------SS----------------------------------------SQS-------------
--------------------------------------------------------------------------------------------------------------------------------------------
----------------------E----------------------------------------------------------------------------------------------------E----------------
--------------------------------------------------------------------------------------------------------------------------------------------
X--Q--Q--Q----SS----S?S------SSSS------S-----<>----------Q--Q--QS-Q-----X--X-------------------------<>----------SSSS----S?S------S?S----SSS
---------------------------------------------[]------------------------XX---X--X---------------------[]-------------------------------------
---------------------------------------------[]-----------------------XXX---XXX----------------------[]------<>-----------------------------
---------------------------E-E----------E-E--[]----E-<>--------------XXXX---XXXX---<>-----------E----[]------[]--E------------E-E----E-E----
XXXXXXX--XXXXXXXXXXXXXXXXXXXXXXXXXXXXXXXXXXXXXXXXXXXXXXXXXXXXXXXXXXXXXXXXXXXXXXXXXXXXXXXXXXXXXXXXXXXXXXXXXXXXXXXXXXXXXXXXXXXXXXXXXXXXXXXXXXX