--------------------------------------------------------------------------------------------------------------------------------------------
--------------------------------------------------------------------------------------------------------------------------------------------
--------------------------------------------------------------------------------------------------------------------------------------------
--------------------------------------------------------------------------------------------------------------------------------------------
--------------------------------------------------------------------------------------------------------------------------------------------
SS----?S----?SS-SSSSS---S-S-------------------------Q---------------------------------------------------------------------------------------
--------------------------------------------------------------------------------------------------------------------------------------------
--------------------------------------------------------------------------------------------------------------------------------------------
-----------------------------------------------------------------------------------------------------XX-------------------------------------
--------------SS---------------Q-------SQS----Q--QS-Q--Q--------<>-------<>--------------------------XXX-------------------------<>---------
---------------------------X------------------------------------[]-------[]------------E---<>------XXXXX-------------------------[]---------
---------------------------X----------------------------X-------[]-------[]-----------<>---[]------XXXXX----------------<>-------[]---------
---------------------------<>---------------E-E--E------E-E---E-[]-------[]-----------[]---[]-----XXXXXXX---------E-----[]--E----[]-------E-
XXXXXXXXXXXXXXXXXXXXXXXXXXXXXXXXXXXXXXXXXXXXXXXXXXXXXXXXXXXXXXXXXXXXXXXXXXXXXXXXXXXXXXXXXXXXXXXXXXXXXXXXXXXXXXXXXXXXXXXXXXXXXXXXXXXXXXXXXXXX