--------------------------------------------------------------------------------------------------------------------------------------------
--------------------------------------------------------------------------------------------------------------------------------------------
--------------------------------------------------------------------------------------------------------------------------------------------
--------------------------------------------------------------------------------------------------------------------------------------------
------------------------------------------------------------E-------------------------------------------------------------------------------
--------------S--------SQSQS---------?------------------S-SSSSSS----------------------------------------------------------------------------
--------------------------------------------------------------------------------------------------------------------------------------------
--------------------------------------------------------------------------------------------------------------------------------------------
--------------------------------------------------------------------------------------------------------------------------------------------
Q--Q--Q--Q-----S----S?SQS-----S-----<>-------X----------X-------------S-------------------------------------------------<>-----------SSQ----
------------------------------------[]------XX-------------------------------------------------------[]-----------------[]------X-----------
------------------------------------[]-----XXX-------------------------------------Q---------o-------<>-----------<>----[]-----XXX-X--------
----------------E-----------EE----E-[]----XXXX-----E------------------------E------X---------S--E-------------E---[]----[]----XXXX----------
XXXXXXXXXXXXXXXXXXXXXXXXXXXXXXXXXXXXXXXXXXXXXXXXXXXXXXXX----------------------------XXXXXXXXXXXXXXXXXXXXXXXXXXXXXXXXXXXXXXXXXXXXXXXXXXXXXXXX