--------------------------------------------------------------------------------------------------------------------------------------------
--------------------------------------------------------------------------------------------------------------------------------------------
--------------------------------------------------------------------------------------------------------------------------------------------
--------------------------------------------------------------------------------------------------------------------------------------------
----E---------------------------------------------------------------------------------------------------------------------------------------
---SSQS-----------------------------------------------------------SSSSQ----Q-------------------------------------------S-----S--SSSQ--------
---------------------------------------------XX---------------------------------------------------------------------------------------------
----------------------------------------------XX--------------------------------------------------------------------------------------------
---------------------------------------------XXX--------------------------------------------------------------------------------------------
---------------------------------------------XXXXX---------SS--S?S---------SS----SS------------------<>----------------Q------S-----------XX
-----------------------------------<>-------XXXXXX---------------------------------------------------[]-----------------------------------XX
----------------------------X------[]------XXXXXXX---XX-----------------------------X-------<>-------[]--------------------------------XXXXX
----------------------------B-EE---[]-----XXXXXXXXX-X-XX--------------E-E---EE-E----E-E-----[]--E----[]-------E-----------------------XXXXXX
----------------------------XXXXXXXXXXXXXXXXXXXXXXXXXXXXXXXXXXXXXXXXXXXXXXXXXXXXXXXXXXXXXXXXXXXXXXXXXXXXXXXXXXXXXXXXXXXXXXXXXXXXXXXXXXXXXXXX