--------------------------------------------------------------------------------------------------------------------------------------------
--------------------------------------------------------------------------------------------------------------------------------------------
--------------------------------------------------------------------------------------------------------------------------------------------
--------------------------------------------------------------------------------------------------------------------------------------------
--------------------------------------------------------------------------------------------------------------------------------------------
---------SSSSQ------------------------------------------------------SQ---------------Q----------SQ--------------------------SQ--------------
--------------------------------------------------------------------------------------------------------------------------------------------
-------------------------------------------------------------------E------------------------------------------------------------------------
--------------------------------------------------S-----------------------------------------------------------------------------------------
-SS-Q--SSS---------S-----XX------------------XX-----------<>-----S-S------S--Q--QSSS---------S----------S-SQS-----SSS---<>--------S------SS-
------------------------XX----------<>-------XX-----------[]-------------------------------------------------------------X------------------
----------------------XXXX--X------B[]------XXX-----------[]------------------------------------------------------------<>-------------X----
-E-----------EEE-E--E-XXXX--B-EE----[]-----XXXX-----------[]----------E-E-E--E----------------------E-----------E-<>----[]----E-E-E----E----
XXXXXXXXXXXXXXXXXXXXXXXXXXX-XXXXXXXXXXXXXXXXXXXXXXXXXXXXXXXXXXXXXXXXXXXXXXXXXXXXXXXXXXXXXXXXXXXXXXXXXXXXXXXXXXXXXXXXXXXXXXXXXXXXXXXXXXXXXXXX