--------------------------------------------------------------------------------------------------------------------------------------------
--------------------------------------------------------------------------------------------------------------------------------------------
--------------------------------------------------------------------------------------------------------------------------------------------
--------------------------------------------------------------------------------------------------------------------------------------------
------------------------------------------------------------E---------------------------E---------------------------------------------------
----SSSS--------SSQ---------------------------------------SSSSS-----------------------SSSSSS--------SSQSS---SSSS------------SSSQ-------SSSQS
--------------------------------------------------------------------------------------------------------------------------------------------
--------------------------------------------------------------------------------------------------------------------------------------E-----
--------------------------------------------------S-----------------------------------------------------------------------------------------
---------------------------------------------XX----------------------------X--------X-------------SS------------S--Q--Q--S----SS----S?S-S---
------------------------------------<>-------XX----------------------------X----------------------------------------------------------------
--------------------------<>X-------[]------XXX----------------<>-X--------XX---------------------------------------------------------------
--------------------------[]S-ES----[]------XXX----------------[]-X--------XXX-------------------------------------E------------------------
XXXXXXXXX--XXXXXXX--XXXXXXXXXXXXXXXXXXXXXXXXXXXXXXXXXXXX---XXXXXXXX-------XXX---XXXX---XXX----XXXXX---X--------XXXXXXXXXXXXXXXXXXXXXXXXXXXXX