--------------------------------------------------------------------------------------------------------------------------------------------
--------------------------------------------------------------------------------------------------------------------------------------------
--------------------------------------------------------------------------------------------------------------------------------------------
--------------------------------------------------------------------------------------------------------------------------------------------
--------------------------------------------------------------------------------------------------------------------E-----------------------
--------------------------------------------------------SSSSSSSS------------------------------------------------S-SSSSSS--------SSQSS---SSSS
---------------------------------------------X----------------------------------------------------------------------------------------------
---------------------------X----------------------------------------------------------------------------------------------------------------
---------------------------------------------XX---S-----------------------------------------------------------------------------------------
-----------------XX--XX--XXX-----------------XX------------------------------------------------------<>---------X-------------SS------------
--------<>------XXX--XX--XXX-------<>-------XXX------------------------------------------------------[]------Xo-----------------------------
X-------[]------XXX--XXX-XXXX------[]------XXXXX------------------------------------X-------<>-------[]-----X<>-----------------------------
E-------[]-----XXXXX-XXXXXXXB-EE---[]------XXXXX------------------------------------E-E-----[]--E----[]----XX[]-----------------------------
XXXXXXXXXXXXXXXXXXXXXXXXXXXXXXXXXXXXXXXXXXXXXXXXXXXXXXXX---XXXX-------X---X----XXXXXXXXXXXXXXXXXXXXXXXXXXXXXXXXX--XXXX-----XXXX--XX----X--XX