--------------------------------------------------------------------------------------------------------------------------------------------
--------------------------------------------------------------------------------------------------------------------------------------------
--------------------------------------------------------------------------------------------------------------------------------------------
--------------------------------------------------------------------------------------------------------------------------------------------
--------------------------------------------------------------------------------------------------------------------------------------------
SSSSSSSS--------SSSSS-----------------------------------------?----SSSSSSSSSS--SS-----------------------------------------------SQS----SS---
--------------------------------------------------------------------------------------------------------------------------------------------
--------------------------------------------------------------------------------------------------------------------------------------------
--------------------------------------------------------------------------------------------------------------------------------------------
--------------S-----------------------------------------X--Q-----Q----SS----S------------------------XX--SSQ-----------------SQS------------
----------------------------------------------------------------------------------------------------XXXX------------------------------------
---------------------------<>----------------<>-------------------------------------X------<>-------XXXX------------------------------------
-----------E---------------[]----------------[]----------------------------------E-EB-E----[]X-----XXXXX------------------------------------
XXXXXXX---XXXXXXXX-----XXXXXXXXX---XXX-----XXXX-XXXXXXXXXXXXXXXXXXXXXXXXXXXXXXXXXXXXXXXXXXXXXXXXXXXXXXXXXXXXXXXXXXXXXXXXXXXXXXXXXXX--XXXXXXX