--------------------------------------------------------------------------------------------------------------------------------------------
--------------------------------------------------------------------------------------------------------------------------------------------
--------------------------------------------------------------------------------------------------------------------------------------------
--------------------------------------------------------------------------------------------------------------------------------------------
----E---------------------------------------------------------------------------------------------------------------------------------------
--SSSSSS--------SSQS-----------------SSQQ-----------------------------------------------------------------------S--------S?QQ------Q------XX
------------------------------------------------------------------------------------------------------------------------------------------XX
----------------------------------------------------------------------------------------------------------------------------------------XXX-
--------------------------------------------------------------------------------------------------------------------S------------------XXXX-
X-------------SS-------------Q--Q--SSSQ--------S-----SS-----------------------------------------------XX---------Q--Q--QS-Q-----X-----XXXX-X
------------------------------------------------------------------------------------X---------------XXXX-----------------------XX----XXXX-XX
--------------------------<>--------------------------------------------------------X------<>-------XXXX----------------------XXX---XXXX-XXX
--------------------------[]-E-----------EEE-E--E-EE--------------------------------B-EE---[]XX----XXXXXX--------E---E-----E-XXXX---XXXXX-XX
---XXX------XX--------------XXXXXXXXXXXXXXXXXXXXXXXXXXXX---------------------------XXXXXXXXXXXXX--XXXXXXXXXXXXXXXXXXXXXXXXXXXXXXXXXXXXXXXXXX