--------------------------------------------------------------------------------------------------------------------------------------------
--------------------------------------------------------------------------------------------------------------------------------------------
--------------------------------------------------------------------------------------------------------------------------------------------
--------------------------------------------------------------------------------------------------------------------------------------------
--------------------------------------------------------------------------------------------------------------------E-----------------------
----------------------------SSQ-------SSSSQ----Q--------SSQ--------SSSQ----Q-----SSS----------SSSS-----Q-----SSS--SSSSSS--------------------
--------------------------------------------------------------------------------------------------------------------------------------------
--------------------------------------------------------------------------------E------------E--------------E-------------------------------
--------------------------------------------------------------------------------------------------------------------------------------------
-SS----<>-Q---------------<>-------S?S---------SS----SS-X--Q--Q--Q----SS---SS--?S-S-----Q--S?S---------SS---S-----------------X----X--------
-------[]------X----------[]--------------------------------------------------------------------------------------------------X----XX-------
-------[]------XX--XX-----[]-----------------------X-------------------------------------------------------------------------------XXX----<>
-----E-EB-EE--XXX--XXXX-E-[]--------------EEE---E--E------------------------E--E-----------------E-EEE--------------------EE---X---XXXX---[]
XXXXXXXXXXXXXXXXXXXXXXXXXXXXXXXXXXXXXXXXXXXXXXXXXXXXXXXXXXXXXXXXXXXXXXXXXXXXXXXXXXXXXXXXXXXXXXXXXXXXXXXXXXXXXXXXXXXXXXXXX--XXXXXX--XXXXXXXXX