--------------------------------------------------------------------------------------------------------------------------------------------
--------------------------------------------------------------------------------------------------------------------------------------------
--------------------------------------------------------------------------------------------------------------------------------------------
--------------------------------------------------------------------------------------------------------------------------------------------
--------------------------------------------------------------------------------------------------------------------------------------------
----------------------------SS-----S-------------------X----------------------------------------------------------S?------------------------
--------------------------------------------------------------------------------------------------------------------------------------------
--------------------------------------------------------------------------------------------------------------------------------------------
--------------------------------------------------------------------------------------------------------------------------------------------
------------QS-------------S-------QS-Q-----X--X--XX---X-SSS--------------S---------------------QS---------------------------------X--------
------------------------------------------XXX---XXXX--XX-------------------------<>-----------------------------------------------XXX-------
-----------------<>-----------------------XXX---XXXX--XX-------------------------[]------------------------------------<>-X-----XXXXXX----<>
------------E----[]--------------E-E--EX-XXXX--XXXXX--XX--------------E-E-E------[]------------------------------------[]-X-----XXXXXXX---[]
XXXX---XXXXXXXXXXXXXXXXXXXXXXXXXXXXXXXXXXXXXXX-XXXXXXXXXXXXXXXXXXXXXXXXXXXXXXXXXXXXXXXXX---XXXXXXXXXXXXXXXXXXXXXXXXXXXXXXXXX--XXXXXXXXXXXXXX