--------------------------------------------------------------------------------------------------------------------------------------------
--------------------------------------------------------------------------------------------------------------------------------------------
--------------------------------------------------------------------------------------------------------------------------------------------
--------------------------------------------------------------------------------------------------------------------------------------------
--------------------------------------------------------------------------------------------------------------------E-----------------------
--------------S-----------------------------------------SS----?S-S?SQ----SSQ------XX--------------S?SQ-----SS---SSSSSSSS---SSSSSSSSS--------
----------------------------------------------------------------------------------XX--------------------------------------------------------
--------------------------------------------------------------------------------XXX---------------------------------------------------------
-------------------------------------------------------------------------------X-X----------------------------------------------------------
X--Q--Q-----QS------S?SQS--Q---------------------Q-------Q--Q--QS-Q-----------XX--XXX-----------QSQS--------------------------S-------------
-----------------------------------------------------------------------X-----XXX--XX--------------------------------------------------------
----------------------------------------------------------------------XXX---XXXX--XX------------------------------------------------------<>
----------------E----E------------------------E--------------------E-EXX---XXXXXX-XX---------------------------E---------------------------B
XXXXXXXXXXXXXXXXXXXXXXXXXXXXXXXXXXXXXXXXXXXXXXXXXXXXXXXXXXXXXXXXXXXXXXXXXX-XXXXXXXXXXXXXXX--XXXXXXXXXXX---XXXXXXXXXXXXX-XXXXXXXXXX---XXXXXXX