--------------------------------------------------------------------------------------------------------------------------------------------
--------------------------------------------------------------------------------------------------------------------------------------------
--------------------------------------------------------------------------------------------------------------------------------------------
--------------------------------------------------------------------------------------------------------------------------------------------
--------------------------------------------------------------------------------------------------------------------------------------------
-----------------------------------------SSQ-------SSSQS-----------------------------------------------------------------Q-----------------X
--------------------------------------------------------------------------------------------------------------------------------------------
--------------------------------------------------E------------------------------------------------------------------------------X----------
--------------------------------------------------------------------------------------------------------------------------------------------
----------------------------X--Q--Q--Q----SS----S?S-S-------------------------S------SQ--------------<>-----------S----<>-------XX--XXXX----
-----------------<>----------------------------------------------------------------------------------[]----------------[]------XXX--XXXX-XXX
X-<>----<>-------[]---------------------------------------<>------------------------X-------<>-------[]------<>--------[]-----XXXX--XXXX-XXX
B-[]----[]-------[]-------E--------------------------------Q------------------------<>E-----[]-------[]------[]----E-E-[]----XXXXX-XXXXXXXXX
XXXXXXXXXXXX-XXXXXXXXXXXXXXXXXXXXXXXXXXXXXXXXXXXXXXXXXXXXXXXXXX-----------X-------XXXXXXXXXXXXXXXXXXXXXXXXXXXXXXXXXXXXXXXXXXXXXXXXXXXXXXXXXX