--------------------------------------------------------------------------------------------------------------------------------------------
--------------------------------------------------------------------------------------------------------------------------------------------
--------------------------------------------------------------------------------------------------------------------------------------------
--------------------------------------------------------------------------------------------------------------------------------------------
--------------------------------------------------------------------------------------------------------------------------------------------
----------------------------SSSSSSSS-----S--SSSQS------X------------------------------SSSQ--------------------------------------------------
-------------------------------------------------------X------------------------------------------------------------------------------------
--------------------------------------------------------------------------------------------------------------------------------------------
--------------------------------------------------------------------------------------------------------------------------------------------
--------------------------<>--------------S?-------X--XX----------------------S-------------------X----X-----------S-------------<>---------
-------------------------B[]----------------------XX--XX---------------------------------------X--XX---XX---------------<>-------[]---------
-------------------------<>X---------------------XXX--XX-----------------------------------<>-XX--XXX--XXX----<>X-------[]-------[]-------B-
------------------E-----EXXX--------------------EXXXX-XX-----------------------------------[]XXX---XX--XXXX---[]E-EB----[]--X-E--[]------<>-
XXXXXXXXXXXXXXXXXXXXXXXXXXXXXXXXXXXXXXXXXXXXXXXXXXXXXXXX------------------X----X--XX---XXXXXXXXX--XXX--XXXXXXXXXXXXXXXXXXXXXXXXXXXXXXXXXXXXX