--------------------------------------------------------------------------------------------------------------------------------------------
--------------------------------------------------------------------------------------------------------------------------------------------
--------------------------------------------------------------------------------------------------------------------------------------------
--------------------------------------------------------------------------------------------------------------------------------------------
--------------------------------E-----------------------------------------------------------------------------------------------------------
----------------------------SSSSSSSS---------------------------------Q-----------------SS---------------------------------------------------
--------------------------------------------------------------------------------------------------------------------------------------------
-----------------X--------------------------------------------------------------------------------------------------------------------------
-----------------X--------------------------------------------------------------------------------------------------------------------------
-------<>-------X--XX-X---<>--------------------------<>--SS-----B-------<>--Q-----S----------------------------------------QS--------------
-------[]------XXX-XXX----XX---------------------------S--------<>-------[]-----------------------------------------------------------------
-------[]-----XXXX-XXXX---XX-------------------XXX----<>X-------[]-------[]-----------------------------------<>----------------------------
---E-E-[]----XXXXX-XXXX---XX-------------------XXXX---[]E-E-----[]----E--[]--E---------------------------------B------------E-----E---------
XXXXXXXXXXXXXXXXXXXXXXXXXXXX---X--X-------------XXXXXXXXXXXXXXXXXXXXXXXXXXXXXXXXXXXXXXXXXXX--------------------XXXXXXXXXXXXXXXXXXXXXXXXXXXXX