--------------------------------------------------------------------------------------------------------------------------------------------
--------------------------------------------------------------------------------------------------------------------------------------------
--------------------------------------------------------------------------------------------------------------------------------------------
--------------------------------------------------------------------------------------------------------------------------------------------
----------------------------------------------------------------------------------------E---------------------------------------------------
-----SS------S----------SSS---------------------------------------------------------SSSSSSSS-------------------------------------------SQS--
--------------------------------------------------------------------------------------------------------------------------------------------
--------------------------------------------------------------------------------------------------------------------------------------------
--------------------------------------------------------------------------------------------------------------------------------------------
X-------------SS------------------------QS----S--Q-----S-----------------XX--X--XX------------------------X---<>X-----------QSQS----S?S-Q--Q
----------------------------------------------------------------<>-------XX--XX-XX-----------------------XX---[]----------------------------
--------------------------------------------------------X-------[]------XXX--XXXXX----------------------XXX---XB----------------------------
----------------------------------------------E--E------E-EE----[]-----XXXX-XXXXXX------------E--------XXXX-X-XX----------------------------
XXXXXXXXXXXXXXXXXXXXXXXXXXXXXXXXXXXXXXXXXXXXXXXXXXXXXXXXXXXXXXXXXXXXXXXXXXXXXXXXXXXXXXXXXXXXXX----XXX--XXXXXXXXXXXXXXXXXXXXXXXXXXXXXXXXXXXXX