--------------------------------------------------------------------------------------------------------------------------------------------
--------------------------------------------------------------------------------------------------------------------------------------------
--------------------------------------------------------------------------------------------------------------------------------------------
--------------------------------------------------------------------------------------------------------------------------------------------
--------------------------------------------------------------------------------------------------------------------------------------------
----------------------------SSS-------------------------------------------------------------------------------------------------------------
-------------------------------------------------------X------------------------------------------------------------------------------------
-------------------------------------------------------X------------------------------------------------------------------------------------
-------------------------------------------------------X------------------------------------------------------------------------------------
X--Q--Q-----QS----S--Q--Q--Q-Q-----Q--Q----------XX--XXX--------<>-------XX-XX-XX---------------Q--------SSQ----------------------XXXXX---<>
-------------------------------------------------XX--XXX--------[]------XX--XXX--------------------------------------------------XXXXXX---[]
-------------------------------------------XXX---XXXXXXXX-------[]-----XXXX-XXXX------<>-------------------------------<>------XXXXXXXX--XXB
---------------------E---------------------XXXX-XXXXXXXXE-EE--E-[]----XXXX--XXXXX-----[]---------------------------E---[]-X----XXXXXXXX---XX
XXXXX--XXXXXXXXXXXXXXXXXXXXXXXXXXXXXXXXXXXXXXXXXXXXXXXXXXXXXXXXXXXXXXXXXXXXXXXXXXXXXXXXXXXXXXXXXXXXXXXXXXXXXXXXXXXXXXXXXXXXX--XXXXXXXXXXXXXX