--------------------------------------------------------------------------------------------------------------------------------------------
--------------------------------------------------------------------------------------------------------------------------------------------
--------------------------------------------------------------------------------------------------------------------------------------------
--------------------------------------------------------------------------------------------------------------------------------------------
------------------------------------------------------------E-------------------------------------------------------------------------------
---------------------------------------------SSS--------SSSSSSSS--------SSQS------------------------------------SSSSSSSS--------S-----------
--------------------------------------------------------------------------------------------------------------------------------------------
--------------------------------------------------------------------------------------------------------------------------------------------
--------------------------------------------------------------------------------------------------------------------------------------------
--------S-----------------X--------Q------S-------------X-------------S?-------------SQ--------------<>----------------Q--Q---X-X--X--------
-------------------------XX--------------------------------------------------------------------------[]-----------------------XX---XX-------
-----------------S-----XXXXX------------------------------------------------------<>X-------<>-------[]------<>---------------XXX--XXX----<>
---------------EEX----XXXXXX---------------E--------------------------------------[]<>------[]--E----[]------[]--------EE-EE-XXXX--XXXX---[]
XXXXXXXXXXXXXXXXXXXXXXXXXXXXXXXXXXXXXXXXXXXXXXXXXXXXXXXX--XXXX------XXX-------------XXXXXXXXXXXXXXXXXXXXXXXXXXXXXXXXXXXXXXXXXXXXXX-XXXXXXXXX