--------------------------------------------------------------------------------------------------------------------------------------------
--------------------------------------------------------------------------------------------------------------------------------------------
--SXSXSXSSSSSS-----------------------------------------------------------SSSSSS-------------------------------------------------------------
X---X-X-------------------------------------------------------------------------------------------------------------------------------------
--------------------------------------------------------------------------------------------------------------------------------------------
-----XX----------------------------SSSSSSSSSSSSS--------------------EQ--S?SS-----------SSSS-------------------------------------------------
--------------------SX-------------------------------------SX---------------------------------------------------XXXX--------------------SXX-
------------------------X----X---------------------------------E----------------------------------------------------------------------------
-----------------------XXX--SX------------------------S-------<>--E----------E----------------------SXSX------------------------------------
--S--------XXXXX------XXXXX-X---------SSSSSSSSS------SSS------[]-------SESS-<>---E-------------------------------------------------SS-------
---------------------XXXX---------------------------------<>--[]----SSS-SXX-[]---XX-<>------------------------------------------------------
---------------------XXX----X-----------------------------[]--[]---SSSS-----[]---E--XX------------------------------------XXXXX-------------
------------------XX--XXX---X-----S---------------------X-X---[]----SSS-----[]------<>-------------------------------------XX---------------
---XXX--XXX-------X---------XX--XXXXXXXX-XXXXXXXXXXXXXXXXXXXXXXXXXXXXXXXXX-XXXXXXXXXXX--XXXXXXXXX-----X---XXXX--XXXX-XXXXXXXXXX-XXXXXXXXXXXX