--------------------------------------------------------------------------------------------------------------------------------------------
--------------------------------------------------------------------------------------------------------------------------------------------
----------------------------------------SSSSSSSSSSSSSSSS------------------------------------------------------------------------------------
----------------------------------------------------------------------------------------------------E---------------------------------------
-------------------------------------------------------------------------------------XXXXXX----XXXXXXXXX------------------------------------
----------------SSSS-------S----------------S---------------------------------------S?S---X-SXXX-------XSXS-----------------------------X---
-------------------------------SX-----------------------------------------------------------------------------------------------------------
-----------------------------XXXX-----------------------------------------------------------E-----------------------------------------------
--------------------------------------E---------------------------------------------------------------------------X------SSSSSSSS-----------
X---------------QQQ--SSS------X----------SSES---[]-----X---------------------------ESSSSSSSS------------------------------------------XXX---
---------------------------------------S--------<>--E-XX--------------------------<>--------------------------------------------------------
<>----SS-------------------------SS------SX------------X--------------------------[]<>------X--------------<>-------------------------------
[]----S-----------------------X--SXS-ES-<>-----<>o-----X------------------------E-[]-----------E-E-----E---[]-------------------------------
XX--XXXXXXXX---XXXXXXXXXXXXXXXXXXXXXXXXXXXXXXXXXXXXXXXXX------XXXX----------XXXXXXXXXXXXXXXXXXXXXXXXXX-XXX-XX---XXXXXXXXXXXXXXXXXXXX--------