--------------------------------------------------------------------------------------------------------------------------------------------
--------------------------------------------------------------------------------------------------------------------------------------------
--------------------------------------------------------------------------------------------------------------------------------------------
--------------------------------------------------------------------------------------------------------------------------------------------
---------------------------------------------------E----XXXXX----------S-------------SXXXXX----XXXXXXXXX------------XXX---SXSXSXSXSX--------
----------------------------S------------------------X---------------------------S---------------------------S------------------------------
------------------------XXXX----------------------------------------------------------------------------------------------------------------
--------------------------------------------------------------------------------------------------------------------------------------------
--------------------------------------SSSS--------------------------------------------------------------------------------------------------
----------X-----------------XXX-------------------------------S-S-----------------<>E--S?---------------------E----S?-----------------------
----------XXXXXX-----------------------------------------------------------------B[]-----S-------------------<>------S-----------------XXXX-
----------XXX-X--------------------------------------XXX--------------------------[]?----------------------<>[]-----------------------XXXXX-
----------XXX--------------------E----------------------------------------EE----EB[]-<>-E---SS---EE-EE-E-E<>-[]---E-E---SS----E--E---XXXXXX-
XXXXXXXXXXXXXXXXXXXXXXXXXXXXXXXXXXXX--XXXXXXXXXX--------XXXX-XXXXX---XXXXXXXXXXXXXXXXXXXXXXXXXXXXXXXXXXXXXXXXXXXXXXXXXXXXXXXXXXXXXXXXXXXXXX-