--------------------------------------------------------------------------------------------------------------------------------------------
--------------------------------------------------------------------------------------------------------------------------------------------
-------------------------------------------------------------SSSSSSSSSSSSSSSSSSSSSSS--------------------------------------------------------
--------------------------------X-----------------------------SSSSSSSSSSSSS-----------------------------------------------------------------
---------------------------------------------------------------SSSSSSSSSSSS-----------------------------------------------------------------
-----XX----------------------------------------------------S-----SSSSSSSSSS------------------------------------------------SEQ--E-----------
-----XX---------------------------------------------------SSX-------------------------------------------------------------------------------
---------------------------------------------------------XXXX-------------------------------------------------------------------------------
--------------------------------E---------------------XX----------E---------------------------E----------E---------------------------E------
--S--------XXXXX--------XXXX---<>---------------S--XXXXX------<>-SS-SSSSSS-------SSS--X------<>---------<>----------------------SSS-S-------
----------------------XXX------[]-----------------XXXXXX-------o---SSSS--S--E-------------E--[]---------[]-----E---E--------SSS-------------
----------------------XX-------[]----<>---------XXXXXXXX------SS----SSS----<>---------X------[]---------[]-------------------S--------------
----------------------XX-------[]---<>B---------XXXXXXXX--X--SXS-ESSSSS----[]---------X---E--[]---------[]-----E--<>--<>------------E-E-----
XXXXXX--XXX------XXXX-------XXXXXXXXXXXX-XXXXXXXXXXXXXXX--XXXXXXXXXXXXXXX-XXXXXXXXXXXXXXXXXXXXXXXXXXXXXXXXXXXXXX--XXXX--XXXXXXXXXX--XXXXXXXX