--------------------------------------------------------------------------------------------------------------------------------------------
--------------------------------------------------------------------------------------------------------------------------------------------
--------------------------------------------------------------------------------------------------------------------------------------------
--------------------------------------------------------------------------------------------------------------------------------------------
----------------------------------------------------------------E-----------------------------------------------XXXXXXX-----XXXSX-----------
---------------------------------S------------------------SSSSSSS----------------------SSSS----------------------E--------------------------
------------------------------SS--------------------------S------------XEX--------------------------------------X-----X---------------------
------------------------------SSSX------------------------SXSX--------E---------------------------------------------------------------------
-----------------------------X-----------SXSXSX------------------------SXXX-------------------------SX-X------------------------------------
--------------------------------------------------------XXXX-XXX-------------------------XXX------------------------------------------------
---------E------------X-X---------------E-------E-------XXX--------XE-----E------------------------------------------------------------E----
---------------------XX-------------SXS---------B-------XX-XS---SXSXX---------------------------------------------------XS-------------<>---
--------------------XXXX-------XS--S-----------------E-EXXSXS--SSX--X------------E-E-------------------------EE--------------E--------<>----
XXXXXXX-XXXX-XXXXXXXXXXX---XXXXXXXXXXX--XXXXXXXXXXXXXXXXXXXXXXXXXX-----XXXXXXXXXXXXXXXXXXXXXXXXX---XXXXXXXXXXXXXXXXX-XXXXXX-XXXXXXXXXXXXXXXX