--------------------------------------------------------------------------------------------------------------------------------------------
--------------------------------------------------------------------------------------------------------------------------------------------
SSSSSSSSSSSSSSSSS-----------SSXSXSXSXSSSSSSSSSSS-------------------------------------------------------SSSSSSSSS----------------------------
---------------------------------------------------X----------------------------------------------------------------------------------------
--------------------------------------------------------------------------------------------------------------------------------------------
-----------------------------------------------E--S----------S----------------------X--S-------SSQ--S?SS------------------------------------
--------------------SXSX------------------------XXSX-----------------------------------SX---------------------------------------------------
-------------------------------------------------------------------------------------------E---------------------XSXSX----------------------
XXX----------XXX------------XXX----------XXX----------------------------------------------<>--E----------E-------------------SXSX-----------
----------E----------XXXXX------------E----------XXXXX------------------------------------[]---SSS-SSSS-<>---E-----------------------------S
----------B----------X----------------------------------------------------------------<>--[]----SSS-SX--[]----------------------------------
-------------------XXX-------------------------XX-------------------------------------[]--[]---SSSS-----[]--------------S-------------------
------------------XXXX--XX-X------------------XXX---X-----------------------------E-X-XS--[]----SSS-----[]---------XS-------E---------------
-------XXXX--XXX----------XX-------------XXX----------XXXXXXXXXX-------X-XX-X-XXXXXXXXXXXXXXXXXXXXXXXX-XXXXXXXXXXXXXXXXXXXXXXXXXXXXXXXXXXXXX