--------------------------------------------------------------------------------------------------------------------------------------------
--------------------------------------------------------------------------------------------------------------------------------------------
------SSSSS-SSSSS-----------------------------------------------------SSSSSSSSSS--SS--------------------------------------------------------
-------------SSS----------------------------------------------------------------------------------------------------------------------------
-------------SS-----------------------------------------------------------------------------------------------------------------------------
--------SSSSSSSS-------X---X------------------------------------SS-S--SSSS-Q----------------------?------------S-S-S-------------X----------
-----------------------------------------------------------------------------------------------------------SXSX-----------------------------
---------------------------------------------------------XXXX------------------------------------------------------------------X------------
--------------SSS------EXXSX-----------------------------------------S------------------------------------------X-X-----------XX-X---------S
----------SSS--SSS-------------<>--------------SSS----E-------------S--QS----------------------------------S---E----------------------------
----------------------------b--[]--------------------<>------------S------------------------------XX---E------<>------------X---------------
-----------------------XX---b--<>--------------------[]--------------------<>---------------------E---<>------[]--SX-----XXXXXX-------------
-----------------------------E-[]---SS----E-E----EE--[]-------------EX-----[]------X------------------[]------[]--SX-----------------------B
-------XXXXX--XXXXX---------XXXXXXXXXXXXXXXXXXXXXXXXXX----XXXXXXXXXXXXXXXXXXXXXXXXXXXXXX-XXXXX--XXXXXXXXXXXXXXXX---------------------------X