--------------------------------------------------------------------------------------------------------------------------------------------
--------------------------------------------------------------------------------------------------------------------------------------------
-----SSSSSSSSSSSSSSSSSSSSSSS----------------------------------------------------------------------------------------------------------------
-----SSSSSSSSSSSSSSS------------------------------------------------------------------------------------------------------------------------
-------SSSSSSSSSSSSS-------------------------------------------------------------------------------------------------------------------EEEE-
--------SSSSSSSSSSSS---------------------------------------------------------------------XX---------------------SSS?---X---SXSXSX----XXXXXXX
----------------------------------------------------------------------------------------XXX------------X------------------------------------
-XX-----------------------------------------------------------------------------------------------------------------------------------------
-X-----------S--E------E--SX-----------------------------------Q--E----------E--------------------------------------------SXSX--------------
X------?-SSSSSSSSSS------SSS----------------------------------<>--X-----E---<>---E-------------XXXXX--------XXXXXXXX------------------------
-----------SS---------------------------------------------<>--[]-<>------X--[]-----------------------------XXX------------------------------
------------SSS-------------------------------------------[]--[]-[]---------[]---------------------------X-XX-------------------------------
------S-----SS-----<>----------------------E--------E-E---[]--[]-[]---------[]---------------------------X-XX-------------------------------
XXXXXXXXXXXXXXXXXXXXXXXXXXXXXXXXXXXXX-----XX-XXXXXXXXXXXXXXXXXXXXXXXXXXXXX--XXXXXXXX--------------------XXXX----XXX--------X----------------