--------------------------------------------------------------------------------------------------------------------------------------------
--------------------------------------------------------------------------------------------------------------------------------------------
-----------------------------------------------------------------------------------------------------------------SSSSSSSS-------------------
-XEX-E--------------------------------------------------------------------------------------------------------------------------------------
---XXXX---SXSXSX----------------------------X-----------------------------------------------------------------------------------------------
--------------------------------------XXX--SX--XXX---E--------------------Q-----------------------------------------------------------------
--------------------------------------------------------------------------------------------------------------------------------------------
--------------------------------------------------------------------------------------------------------------------------------------------
---------------------------------------------------------------S------------------------------E----------E----------------------------------
---SX--------------------XX-------E---------------------------<>--------E?QQQQ---<>---------------------<>-------------------X-------XXXXX--
-----------------------XXXXX------------------------------<>--[]-----------------[]B--------------------[]---------------------------XXXX---
B--<>---<>------------XXXXX-----------------------------XS[]--[]-----------------[]---------------------[]---------------------------X------
-<>[]---[]-----------XXXXXX-------------------------E---X-X---[]-----------------[]---X---E--EE-E-------[]--------------------------XX--X---
XXXXXXXXXXXXXXXXXXXXXXXXXXX-X----XXXX-----X-----X--XXXXXXXXXXXXXXXXX-XXXXXXXXXXXXXXXXXXXXXXXXXXXXXXXXXXXXXXXXXXXXXXXXX---XXX---XXXXXXX----XX