--------------------------------------------------------------------------------------------------------------------------------------------
--------------------------------------------------------------------------------------------------------------------------------------------
--------------------------------------------------------S----SS-SSSSSSSSSSSSSSSSSSSS--------------------------------------------------------
-------------------------------------------------------------S----SSS---SSS-----------------------------------------------------------------
---------------------------------------------------------------SS-SSS--SSSSS----------------------------------------------------------------
-----E?SS----------Q------------------------------------X--S------SSSSSSSSSS----------------------------------------------X-----------------
------------------------------------------------SXSX------SSX-------------------------------------------------------------------------------
-XXXSX---------------------------------------------------------E----------------------------------------------------------------------------
----------------XSX---------XXX----------XXX------------?-----<>--E----------E-----X----------SXSX------------------------------------------
XXX------------Q---------S-S----------E----------XXXXXX-------[]--SSSSSSSSS-<>---EQQ--------------------------------------------------------
XXX---------------E-E-------------------------------------<>--[]---SSSS-SX--[]--------------------------------------------------------------
XX--S-----------------------------------------------------[]--[]---SSSS-----[]--------------------------------------------------------------
XX-XS-------E-----------------------------------E-------X-XX--[]---SSSS-XS-<>EE--------------------------------X----------------------------
XXXXXXXXXXXXXXXXXXXXXXXXXXXX--------------------------XX--XXXXXXXXXXXXXXX---XXXXXXXXXXXXXX---------XXXX-X-----XXX-----X-------------XXXXXXXX