--------------------------------------------------------------------------------------------------------------------------------------------
---------------------------------------------------------------------S----------------------------------------------------------------------
--------------------------------------------------------SS---SSSSSSSSSSSSSSSSSSSSSSS--------------------------------------------------------
----------------------------------------------------------------SSSSSSSSSSSSS---------------------------------------------------------------
-----------------SX--------------------------------------------SSSSSSSSSSSSS----------------------------------------------------------------
--------------------------------------------------------X--S------SSSSSSSSSS----------------------------------------------------------------
----------------------------------------------------------SSX-------------------------------------------------------------------------------
---------------------------------------------------------------E----------------------------------------------------------------------------
--------------------------------E-------E---------------------<>-------------E----XX--------------------------------------------------------
----S?SSS-----------------<>---<>---------------S-----------E-[]---SSSSSSSS-S----XXX--------------------------------QQ----------------------
--------------------------[]B--[]-----E--------------E-----<>-[]---SSSS-S------XXXXX--------------------------------------------------------
-------------------------S[]---[]----<>--------------------[]-[]---SSSS-----X-XXXXXX--------------------------------------------------------
-E-----------E-EE-E----XXXQ----[]----[]-----------E-------<>--[]---S-SS----<>-X--XXX-------------------------------------------EEEEE--------
XXXXXXXXX--XXXXXXXXXXXXXXXXXXXXXXXXXXXXXXXXXXXXXXXX--X----XXXXXXXXXXXXXXXXXXXXX-XXXXXXXXXXX-XXXXXXXX------------XXXXXXXXXXXXXXXXXXXXXXXXXXXX