-----------------------------------E--------------------------------------------------------------------------------------------------------
--------------------------------------------------------------------------------------------------------------------------------------------
----------------------------------SSSSSSSSSSSSSSSSSSSSSS------------------------------------------------------------------------------------
---------------------------------SSSSSSS--S-------------------------------------------------------------------------------------------------
-----------------------------------SSSSS-SSSS-------------------E-----------------------------------------------X-X-------------------------
---------------------------------------S--SSSS------------SSSSSS-----------------------------------SX---------------------------------------
------------------------------SSX-------------------------SS------------E---------------------------------------XXXX---X----------------XX--
-----------------------------XXXX-------------------------SSS-------------------------------------------------------------------------------
---------------XXX-----------X--------E--SX-------------SX---------S---SXXX-----------------------------------------------------------------
----------------------------X--------SS-SSSSS--------SSSX--X-XXX-------------------------------------------------------------------SSS------
---------------------------------------S--------E-------------------E----------------------------------------------------------E----------E-
---------------------------------S-------SB----<>--------X-X----SXS-------------------------------------------------------------------------
-------------------------------SSSX---S-<>-----[]--------XSXSE-SSX---------------E-----------------E--E-------------------------------------
XXXXXXXXXXXXXXXXXXXXXXXXXXXXXXXXXXXXXXXXXXXXXXXXXXXXXXXXXXXXXXXXXXXXXXXXXXXXXXXXXXXXXXXXXXXX------XXXXXXXXXXXXXXXXXX--XXXX--XXX---XXXXXXXXXX