--------------------------------------------------------------------------------------------------------------------------------------------
--------------------------------------------------------------------------------------------------------------------------------------------
------------------------------------------------------------------------------------------------------------------------SSSSSSSSSSSSSSSSSSSS
--------------------------------------------------------------------------------------------------------------------------------------------
--------E-----------------------------------------------------------------------------------------------------------------------------------
--SSSS-----------X----------------------------------------SSS--------SQ---------SSSS-------------------------------S----------S-SS----------
-----------E--XXXX---------------------------------------------------------------------SX--------------------------SX-----------------------
-----------------X--------------------------------------------------------------------XXX---------------------------------------------------
----------------SX-X----------X---------XXSX--------------------------------------------------E---------------------------E-----------------
---X---------------------------X------------------XXX-------------------------------X-X------X---SSE-----E---Q--------<>-SS--SSSSS--X----QQS
---------XXXXXXX--------------------------------------------------XXXXXX------------X-X--------------X--<>-------------B----SSS--X--XE------
---X------X-------------------------------------------------------------------------X----S-------X------[]-------------------SS-----X-------
---X---------------------EEE---------------------------X--------------------------E-X-X--SX---S-<>------[]--------X---<>-ES-SSS----<>-------
XXXX-XX-------------X-XXXXXX---------------XXXX--------X----------------------XXXXXXXXXXXXXXXXXXXXXXXXXXXXXXXXXX--XXXXXXXXXXXXXXX---XXXXXXXX