--------------------------------------------------------------------------------------------------------------------------------------------
--------------------------------------------------------------------------------------------------------------------------------------------
--------------------------------------------------------------------------------------------------------------------------------------------
XXXXXXX-------------------------------------------------------------------------------------------------------------------------------------
-----XX---SXSXS-------------------------SXSX--S---------------------------------------------------------------------------------------------
----------------------------XQ----------S?----Q----------------------------------------------------------------------------XX---X---XXS--E--
--------------------------------------------------------------------------------------------------------------------------------------------
-----------E--X-----------------------------------------------------------------------------------------------------------------------------
----E----?--E------------------<>-------E-------------EX------------------------------------------------------------------------------------
---<>------------------X----?--[]-----------QQQQQ----<>----------<>----------E--------S---------------------X-------------------------------
---[]------------------XXXX-X--[]--------------------[]-------E--[]---------<>----------------------------XXXX------------------------------
B--[]---<>------------XXXXX-E--[]------SS------------[]----------[]-XXX-----[]---------------------------XXXXX------------------------------
-<>[]---[]----------XXXXXXX-E--[]---------E--E--EEE--[]---X------[]---------[]----------------------------XXXX------------------------------
XXXXXXXXXXXXXXXXXXXXXXXX-X--XXXXXXXXXXXXXXXXXXXXXXXXXXX-XXXX-XXXXXXX----XXXXXXXXXXXXXXXXXXXXXXXX---XXXXXX--X--------------------------------