--------------------------------------------------------------------------------------------------------------------------------------------
--------------------------------------------------------------------------------------------------------------------------------------------
--------------------------------------------------------S----SS-SSSSSSSSSSSSSSSSSSSS--------------------------------------------------------
--------------------------------------------------------------------------------------------------------------------XXXX--------------------
----------------------------------------------------------------S---S-----------------------------------------------------------------------
--------------------------------------------------------X--S------SSSSSSSSS----------------------SXS--------SSS-----------------------------
----------------------------------------------------------SSX-----------------------------------------------------XXXE----------------------
---------------------------------------------------------------E----------------------------------------------------------------------------
-------------XXX--------------------------------------X-?-----<>--E----------E-----X--------------------------------------------------------
---------------------X-------------------------------XXX------[]----SSSSSX--<>---ESX-----------------------------------------XXX------X-----
----------------------------------------------------XXXX--<>--[]----SSS-SX-X[]--XXXX-------------------------------------E------------X-----
---------XX------------------------S-----------------XXX--[]--[]---SSSS-----[]X-XXXX-------------------------------------E-----------XX-----
---------X----------EE------E--E--------------------XXXX--[]--[]-----SS-XE-<>BX--XXX--------------------------E---------------------XXXX----
-X-------X---------XXX--XXXXXXXXXX----X--XXXXXXXXXXXXXXX-XXXXXXXXXXXXXXXXXXXXXX-XXXXX-----X-----------------XXXX---XXX--XX-------XXXX--X-XXX