--------------------------------------------------------------------------------------------------------------------------------------------
--------------------------------------------------------------------------------------------------------------------------------------------
--------------------------------------------------------------------------------------------------------------------------------------------
--------------------------------------------------------------------------------------------------------------------------------------------
--------------------------------------------------------------------------------------------------------------------------------------------
--------------------------------------------------------------------------------------------------------------------------------------------
--------------------------------------------------------------------------------------------------------------------------------------------
------------------SSSSSS?-------------------------------------------------------------------------------------------------------------------
--------------------------------<>-------------------o--------------------------------------------------------------------------------------
--------------------------------[]----------------------------------------------------------------------------------------------------------
--------------------------------[]----------------------------------------------------------------------------------------------------------
--------------------------------[]----------------------------------------------------------------------------------------------------------
--------------------------------[]-B--------------------------------------------------------------------------------------------------------
XXXXXXXXXXXXXXXXXXXXXXXXXXXXXXXXXXXXXXXXXXXXXXXXXXXXXXXXXXXXXXXXXXXXXXXXXXXXXXXXXXXXXXXXXXXXXXXXXXXXXXXXXXXXXXXXXXXXXXXXXXXXXXXXXXXXXXXXXXBX