--------------------------------------------------------------------------------------------------------------------------------------------
--------------------------------------------------------------------------------------------------------------------------------------------
--------------------------------------------------------------------------------------------------------------------------------------------
--------------------------------------------------------------------------------------------------------------------------------------------
------------------------------------------SSSS-----------------------------------------------------------------SSSSSS-----------------------
---------------------------------------?--SSSS-----------------------------------------------------------------SSSSSS-----------------------
----------------------o-------------------SSSS-----------------------------------------------------------------SSSSSS-----------------------
------------------------------------------SSSS-----------------Q-----------------------------------------------SSSSSS-----------------------
------------------------------------------SSSS-----------------------------------------------------------------SSSSSS-----------------------
------------------------------------------SSSS---------------------<>------------------------------------------SSSSSS-----------------------
------------------------------------------SSSS---------------------[]-----------------------------------B------SSSSSS-----------------------
------------------------------------------SSSS--------------E--------------------------------------------------SSSSSS-----------------------
------------------------------------------SSSS----------------------------B------------------------------------SSSSSS-----------------------
XXXXXXXXXXXXXXXXXXXXXXXXXXXXXXXXXXXXXXXXXXXXXXXXXXXXXXXXXXXXXXXXXXXXXXXXXXXXXXXXXXXXXXXXXXXXXXXXXXXXXXXXXXXXXXXXXXXXXXXXXXXXXXXXXXXXXXXXXXXX