--------------------------------------------------------------------------------------------------------------------------------------------
--------------------------------------------------------------------------------------------------------------------------------------------
--------------------------------------------------------------------------------------------------------------------------------------------
--------------------------------S---S-------------------------------------------------------------------SSS---------------------------------
--------------------------------S---S-------------------------------------------------------------------SSS---------------------------------
--------------------------------S---S---Q---------------------------------------------------------------SSS---------------------------------
--------------------------------S---S-------------------------------------------------------------------SSS---------------------------------
---------------------------E----SSSSS-----SSSS?---------------------------------------------------------SSS---------------------------------
--------------------------------SSSSS-----SSSS?---------------------------------------------------------SSS---------------------------------
--------------------------------SSSSS-----SSSS?---------------------------------------------------------SSS---------------------------------
--------------------------------SSSSS-----SSSS-----------------o----------------------------------------SSS---------------------------------
--------------------------------SSSSS-----SSSS--------------------------<>------B-----------------------SSS---------------------------------
---------------------------E----SSSSS-----SSSS--------------------------[]----B-------------------------SSS---------------------------------
XXXXXXXXXXXXXXXXXXXXXXXXXXXXXXXXXXXXXXXXXXXXXXXXXXXXXXXXXXXXXXXXXXXXXXXXXXXXXXXXXXXXXXXXXXXXXXXXXXXXXXXXXXXXXXXXXXXXXXXXXXXXXXXXXXXXXXXXXXXX