--------------------------------------------------------------------------------------------------------------------------------------------
--------------------------------------------------------------------------------------------------------------------------------------------
--------------------------------------------------------------------------------------------------------------------------------------------
------------------------------------------------S---S---S---------------------------------------------------SSS-----------------------------
------------------------------------------------S---S---S---------------------------------------------------SSS-----------------------------
--------------------------Q---------------------S---S---S---------------------------------------------------SSS-----------------------------
------------------------------------------------S---S---S---------------------------------------------------SSS-----------------------------
------------------------------------------------SSSSSSSS----------------------------------------------------SSS-----------------------------
------------------------------------------------SSSSSSSS----------------------------------------------------SSS-----------------------------
------------------------------------------------SSSSSSSS--o-------------------------------------------------SSS-----------------------------
------------------------------------------------SSSSSSSS---------------------<>------------------------------SSS----------------------------
------------------------------------------------SSSSSSSS---------------------[]--------B---------------------SSS----------------------------
-----------------------------E-----------------SSSSSSSS---------------------<>--------B---------------------SSS-----------------------------
XXXXXXXXXXXXXXXXXXXXXXXXXXXXXXXXXXXXXXXXXXXXXXXXXXXXXXXXXXXXXXXXXXXXXXXXXXXXXXXXXXXXXXXXXXXXXXXXXXXXXXXXXXXXXXXXXXXXXXXXXXXXXXXXXXXXXXXXXXXX