----------------------o---------------------------------------------------------------------------------------------------------------------
--------------------------------------------------------------------------------------------------------------------------------------------
-------------------------------------------------------SSSSS--------------------------------------------------------------------------------
-------------------------------------------------------SSSSS--------------------------------------------------------------------------------
--------------------------------------------------------------------------------------------------------------------------------------------
--------------------------------------------------------------------------------------------------------------------------------------------
-------------------------------------------------------?--?--?------------------------------------------------------------------------------
--------------------------------------------------------------------------------------------------------------------------------------------
--------------------------------------B-----------------------------------------------------------------------------------------------------
--------------------------------------b-----------------------------------------------------------------------------------------------------
-------------------------<>----------B-----E------------------------------------------------------------------------------------------------
-------------------------[]-----------------------------------------------------------------------------------------------------------------
-------------------------[]-----------------------------------------------------------------------------------------------------------------
XXXXXXXXXXXXXXXXXXXXXXXXXXXXXXXXXXXXXXXXXXXXXXXXXXXXXXXXXXXXXXXXXXXXXXXXXXXXXXXXXXXXXXXXXXXXXXXXXXXXXXXXXXXXXXXXXXXXXXXXXXXXXXXXXXXXXXXXXX--