--------------------------------------------------------------------------------------------------------------------------------------------
--------------------------------------------------------------------------------------------------------------------------------------------
--------------------------------------------------------------------------------------------------------------------------------------------
--------------------------------------------------------------------------------------------------------------------------------------------
------------------S---S---S---S---S-------------------------------?--SSSSS-----------<>-----------------------------------------------------
----------------------------------------Q-------------------------SSS---------------<>------------------------------------------------------
-------------------------------------------------------------------SSS---------------<>-----------------------------------------------------
--------------------B-------------------------------------B-------SSS---------------<>------------------------------------------------------
------------------------------SSSSSS??-----------------------------SSS----------------<>----------------------------------------------------
------------------------------SSSSSSSS-----------------------------SSS----------------[]----------------------------------------------------
------------------------------SSSSSSSS---o-------------Q-----------SSS-----------------<>---------------------------------------------------
-----------------------E------SSSSSSSS-----------------------------SSS------------------<>--------------------------------------------------
-------------------------------------------------------------------SSS----------------------------------------------------------------------
XXXXXXXXXXXXXXXXXXXXXXXXXXXXXXXXXXXXXXXXXXXXXXXXXXXXXXXXXXXXXXXXXXXXXXXXXXXXXXXXXXXXXXXXXXXXXXXXXXXXXXXXXXXXXXXXXXXXXXXXXXXXXXXXXXXXXXXXXXXX