--------------------------------------------------------------------------------------------------------------------------------------------
--------------------------------------------------------------------------------------------------------------------------------------------
--------------------------------------------------------------------------------------------------------------------------------------------
--------------------------------------------------------------------------------------------------------------------------------------------
-------------------B------------------------------------------------------------------------------------------------------------------------
------<>---------E--------------------------------------------------------------------------------------------------------------------------
------[]------------------------------------------------------------------------------------------------------------------------------------
------[]-------------------o----------------------------------------------------------------------------------------------------------------
-------------------B------------------------------------------------------------------------------------------------------------------------
---------------------SSSS---------------------------------SSSS?Q----------------------------------------------------------------------------
--------------------------------------------------------------------------------------------------------------------------------------------
---------------------------------------------SSSS-------------------------------------------------------------------------------------------
---------------------------------------------XXXXXXXXXXXXXXXXXXXXXXXXXXXXXXXXXXXXXXXXXXXXXXXXXXXXXXXXXXXXXXXXXXXXXXXXXXXXXXXXXXXXXXXXXXXXXX-
XXXXXXXXXXXXXXXXXXXXXXXXXXXXXXXXXXXXXXXXXXXXXXXXXXXXXXXXXXXXXXXXXXXXXXXXXXXXXXXXXXXXXXXXXXXXXXXXXXXXXXXXXXXXXXXXXXXXXXXXXXXXXXXXXXXXXXXXXXXX