--------------------------------------------------------------------------------------------------------------------------------------------
--------------------------------------------------------------------------------------------------------------------------------------------
---------------------------------SS---------------------------------------------------------------------------------------------------------
---------------------------------SS?--------------------------------------------------------------------------------------------------------
-----------------------------------o--------------------------------------------------------------------------------------------------------
-----------------------------------o--------------------------------------------------------------------------------------------------------
------------------------------------<>------------------------------------------------------------------------------------------------------
------------------------------------[]------------------------------------------------------------------------------------------------------
------------------------------------[]-----o------------------------------------------------------------------------------------------------
--------------------------------------------------------------------------------------------------------------------------------------------
--------------------------------------------------------------------------------------------------------------------------------------------
--------------------------------------------------------------------------------------------------------------------------------------------
----------------------------------XXXXXXXXXXXXXXXXXXXXXXXXXXXXXXXXXXXXXXXXXXXXXXXXXXXXXXXXXXXXXXXX--B---------------------------------------
XXXXXXXXXXXXXXXXXXXXXXXXXXXXXXXXXXXXXXXXXXXXXXXXXXXXXXXXXXXXXXXXXXXXXXXXXXXXXXXXXXXXXXXXXXXXXXXXXXXXXXXXXXXXXXX--B--E-----------------------