---------------------------------------------------E-----------------E-------------------E--------------------------------------------------
--------------------------------------------------------------------------------------------------------------------------------------------
-------------------------------------------o----------------o--------------------------------------o----------------------------------------
-------------------------------------------------?----------------?-----------------------------------------------------?-------------------
-------------------------------------------------<>--------------------------------------------------<>-------------------------------------
-------------------------------------------------[]--------------------------------------------------[]-------------------------------------
-------------------------------------------------[]--------------------------------------------------[]-------------------------------------
--------------------------------B---------------------------------------------------------------------B-------------------------------------
-------------------------------Sbb----------------------------------------------------------------------------------SBb---------------------
-------------------------------SBb----------------------------------------------------------------------------------Sbb---------------------
---------------------------------X------------------------------------------------------X---------------------------------------------------
---------------------------------XXX----------------------------------------------------XXX-------------------------------------------------
-----------------E----------------XXXX-----------------E------------------E--------------XXXX-----------------E------------------XXXX-------
XXXXXXXXXXXXXXXXXXXXXXXXXXXXXXXXXXXXXXXXXXXXXXXXXXXXXXXXXXXXXXXXXXXXXXXXXXXXXXXXXXXXXXXXXXXXXXXXXXXXXXXXXXXXXXXXXXXXXXXXXXXXXXXXXXXXXXXXXXXX