--------------------------------------------------------------------------------------------------------------------------------------------
--------------------------------------------------------------------------------------------------------------------------------------------
--------------------------------------------------------------------------------------------------------------------------------------------
--------------------------------------------------------------------------------------------------------------------------------------------
--------------------------------------------------------------------------------------------------------------------------------------------
--------------------------------------------------------------------------------------------------------------------------------------------
----------------------------------------------SSSSSSSS----------------------------------SSSSSSSSSS------------------------------------------
----------------------------------------------?---Q---------------------------------------------------?---Q---------------------------------
----------------------------------------------<>---<>---------------------------------------------------<>----------------------------------
----------------------------------------------[]---[]---------------------------------------------------[]----------------------------------
----------------------------------------------[]---[]---------------------------------------------------[]----------------------------------
----------------------------------------------B-------------------------------------------------------------B-------------------------------
----------------------------------------------b-----E----------o---------------------------------------------B------------------------------
XXXXXXXXXXXXXXXXXXXXXXXXXXXXXXXXXXXXXXXXXXXXXXXXXXXXXXXXXXXXXXXXXXXXXXXXXXXXXXXXXXXXXXXXXXXXXXXXXXXXXXXXXXXXXXXXXXXXXXXXXXXXXXXXXXXXXXXXXXXX