--------------------------------------------------------------------------------------------------------------------------------------------
XXXXXXXXXXXXXXXXXXXXXX------------------------------------------------------------------------------------------------------------------XX--
SSSSSSSSSSSSSSSSSSSSS-X---SSSSSSSSSSSSSSSS-------------SSS--<>SSSSSSSSSSSSSSSS--------------------------------S------------------------XX-X-
-----------------------X--SSSS------------------------------[]SSSSSSSSSSSSSSSS-------------------XXXXXXXXXXX--S-----------------------XX---X
------------------------X-SSSS------------------------------[]SSSSSSSSSSSSSSSS------------------XX------------S-----------------XXXXXXX-----
-------------------------XSSSS-------------XX--XXXXX--------[]SSSSSSSSSSSSSSSS-----------------XXX------------S--------------XXXX---XXX-----
--------------------------X---------------XX-XXX----X-------[]SSSSSSSSSSSSSSSS----------------XXXX------------S-------------XXXXX-----------
----------E----------------X-------------XX--XXX-----X------[]SSSSSSSSSSSSSSSS---------------XXXXX------------S------------XX---------------
---------<>----------------oXXX------XXXXX------------X------oSSSSSSSSSSSSSSSS--------------XXXXXX------------S--------XXXXX----------------
-E-------[]---------------S?SS-X----XX-XXX-------------XXXXX-BSSSSSSSSSSSSSSSS--------E----XXXXXXX------------S-------XX-XXX--------XXX-----
<>-------[]--<>-----E-----SSS---X--XX-----------SSS-S--SSSSSSSSSSSSSSSSSSSSSSS---E---<>---XXXXXXXX----<>------S------XX---------------------
[]---<>--[]--[]----<>-----SS-----XXX------------SSS-S--SSSSSSSSSSSSSSSSSSSSSSS--<>---[]--XXXXXXXXX----[]------S-----XX----------------------
[]---[]--[]--[]----[]-------E-EE--XX------------SSS-S--SSSSSSSSSSSSSSSSSSSSSSS--[]---[]-XXXXXXXXXX----[]------SXXXXXX-----------------------
XX---XX--XX--XX--XXXXXXXXXXX-XXXXXXX---------XXXSSS-S--XXXXXXXXXXXXXXXXXXXXXXX--XX---XXXXXXXXXXXXXXXXXXXXXXXXXXXXXXXX-----------------------