X-------------------------------------------------------------------------------------------------------------------------------------------
XXXXXXXXXXXXXXXXXXXXXXXXXXXXXXXXXXXXXXXXXXXXXXXXXXXX-------------------------------------------------------------XX-------------------------
SSSSSSSSSSSSSSSSSSSSSSSSSSSSSSSSSSSSSSSSSSSSSSSSSSS-X-----SSSSSSSSSSSSSSSSSSSSSSSSSSSS?SSSSSSSSS-SSSSSSSSSSSSSS-XX-X------------------------
o----------------------------------------------------X------------------SSSS-----------------------------------XX---X-----------------------
o-----------------------------------------------------X-----------------SSSS----------------------------------XX-----XXXXXXX----------------
B----------------E-------------------------------------X------------------------ooooooo-----------------XXXXXXXS-----SSSSSS-X---------------
Q---------------<>--------------------------------------X-----------SS---------------------------------XXSSSSSS--------------XXXXX----------
?---------------[]---------------------------------------X--------SSSS----------SSSSSSS---------------XX-SSSSSS---------------XXX-X---------
S---------------[]-------S---------------------E----------X-------SSS----E------SSSSSS---------------XX--SSSSSS---------------XXX--X--------
BSSS-------E--SS[]SS---E----E-----------------<>-----------X------SSS--SSSSS-----------------------XXX---SSSSSSS-------------XXXX---X-------
SSS-------<>----[]----<>---<>--------------XX-[]--XXX-------X---------EE--------------------------XX<>--------S--------------XXXX----X-----X
SSS-------[]----[]----[]---[]-------------XXX-[]--XXX--------X-------------XXXXX-----------------XX-[]--------S---<>-----<>--XXXX-----X---XX
----------[]-E--[]----[]---[]---------E-E-XXX-[]--XXX-------X-XXXXXXXXXXXXXX----XXXXXXXXXXXXXXXXXX--[]------------[]-----[]--XXXX------XXXX-
XXXXXXXXXXXXXXXXXXXXXXXXXXXXXXXXXXXXXXXXXXXX--XX--XX------XXXXXXXXXXXXXXXXXX---XXXXXXXXXSXXXXXXXXXXXXXXXXXXXXXXXXXXXXXXXXXXXXXXX--XXXXXXXXXX