--------------------------------------------------------------------------------------------------------------------------------------------
--------------------------------------------------------------------------------------------------------------------------------------------
--------------------------------------------------------------------------------------------------------------------------------------------
--------------------------------------------------------------------------------------------------------------------------------------------
---------------------------------------------------------------------------------------------oo---------------------------------------------
-------QQQQQ----------SSSS--------SSSSS------SSSS--------------------------------ooo---------oo---------------------------S-----------------
--------------------------------------------------------------------------------------------------------------------------------------------
X----------------------------------------------------------------------XXX-------------------XX---------------------------------------------
-XX-----------------------XXXX-------------------------XXXX-----------XX--XXXX--------------XX----------XXXX-----------------------------XX-
<>-X--E?QQQQ---------S---XX<>-X-QQQQ--QQQ-------------XX<>-X---------XX----X--X-----------EXX--X-------XX<>-X---------------------XXXX--XX-X
[]--X-------------------XX-[]--X---------------------XX-[]--X------XXX----XX---XXXXXXXXXXXXX----X-----XX-[]--X----QQQQQ?--S------XX---XXX---
EB---X-----------------XX--[]---X-----------XXXXX---XX--[]---X----XX<>---XXX---XXXXXXXXXXXXX-----X---XX--[]---X-----------------XX-----X----
So----XXXXXXXXXXXXXXXXXX---[]----XXXXXXXXXXXX----XXXXE--[]----XXXXX-[]---XXX---X-----------X------XXXX---[]----XXXXXXXXXXXXXXXXXXX-----X----
XXXXXXXXXXXXXXXXXXXXXXXXXXXXXXXXXXXXXXXXXXXXX----XXXXXXXXXX---XXXXXXXXXXXX-----X-----------X-----XXXXXXXXXXXXXXXXXXXXXXXXXXXXXXXXX-----X----