--------------------------------------------------------------------------------------------------------------------------------------------
------------------------------------------------------------------------------XXXX----------------------------------------------------------
-----------------------------------------------------------------------------XX---X---SSSSSSSSSSSSSSSS-------------SSS--<>SSSSSSSSSSSSSSSS--
----------------------------------------------------------------------------XX-----X--SSSS------------------------------[]SSSSSSSSSSSSSSXS--
-------------------------------------------------------------------------XXXX-------X-SSSS------------------------------[]SSSSSSSSSSSSSSSS--
------------------------------------------------------------------------XX-<>--------XSSSS-------------XX--XXXXX--------[]SSSSSSSSSSSSSSSS--
------------------------------------------------------E----------------XX--[]---------X---------------XX-XXX----X-------[]SSSSSSSSSSSSSSSS--
--------------------------------------------------XXXXX------------XXXXX---[]----------X-------------XX--XXX-----X------[]SSSSSSSSSSSSSSSS--
------------------------------E---------------XXXXX----X--------XXXX--XE---[]----------oXXX------XXXXX------------X------BSSSSSSSSSSSSSSSS--
?------------------------QQQQQQQ-------------XX-XXX-----X------XXXXX--<>---[]---------S?SS-X----XX-XXX-------------XXXXX-XSSSSSSSSSSSSSSSS--
-------------XXXXXXXXXXXX-------------------XX-----------XE---XX------[]---[]---------SSS---X--XX-----------SSS-S--SSSSSSSSSSSSSSSSSSSSSSS--
-----------------------------------<>------XX-------------X--XX-------[]---[]---------SS-----XXX------------SSS-S--SSSSSSSSSSSSSSSSSSSSSSS--
--------E--------------------------[]----XXX---------------XXX--------[]---[]-----------E-EE--XX------------SSS-S--SSSSSSSSSSSSSSSSSSSSSSS--
XXXXXXXXXXXXXXXXXXXXXXXXXXX-XXXX---XXXXXXXXX--------------XXXXXXX-----[]---XXXXXXXXXXXXX-XXXXXXX---------XXXSSS-S--XXXXXXXXXXXXXXXXXXXXXXX--