--------------------------------------------------------------------------------------------------------------------------------------------
--------------------------------------------------------------------------------------------------------------------------------------------
--------------------------------------------------------------------------------------------------------------------------------------------
--------------------------------------------------------------------------------------------------------------------------------------------
--------------------------------------------------------E-----------------------------------------------------------------------------------
SSSSSSSS-----------------XXX------------------------QQQQQQQQQ---------------------------------------------------XX--------------------------
------------------------XX-<>X----------------------------------------------------------------------------------XX--------------------------
XXXXXXXXX--------------XX---X-X-----------------------------------------------------------------------------XXX-XX--------------------------
SSSSS??S-X------------XX-E--X--X------------XXXX---------E-------------------------------------------------XXXX-XX--------------------------
----------X----------XX--X--X---X----------XX<>-X--E?QQQQQQQQ---------XXX---------------------------------XXXX--XX--------------------------
-oooooo----XX-------XXE--X--X----X--------XX-[]--X-------------------XXo-X-----------XXXX----------E----EXXXXX-XXX-------------------------X
-----------E-X-----XX-X--X--X-----X------XX--[]---X-----------------XX<>--X-------B-XX<>-X---B----------XXXXXX--X--------XXX---------XXXXXXX
-oooooo----o--XXXXXX--X--X--X-----XXXXXXXX---[]----XXXXXXXXXXXXXXXXXX-[]-X-XXXXXXXXXX-[]--XXXXXXXXXXXXXXXXXXXX---XXXXXXXXXX-XXXXXXXXXX--XXXX
XXXXXXXXX--BXXXXXXXX--X--X--XXXXXXEXXXXXXXXXXXXXXXXXXXXXXXXXXXXXXXXXXXXXXXXXXXXXXXXXXXXXXXXXXXXXXXXXXXXXXXXXXXXXXXXXXXXXXXXXXXXXXXXXXX------