--------------------------------------------------------------------------------------------------------------------------------------------
--------------------------------------------------------------------------------------------------------------------------------------------
------------------------------------------------------------------------------------------------------oo-------------------SSSSSSSSSSSS-SSSS
----------------XXXXX---------------------------------------------------------------------------------------------------------[]------------
------XXX--XXX-XX----X----------------------------------------------XXXXX--------------------------------------XX-------------[]------------
------X--XXX--X<>-----X-----------E------------------------------E-XXXXX-X----------------------------XXX------X-X------------<>-------XXXXX
------X---<>---[]------X---------<>-------------------------------XXXXXX--X-----------------------------------XX--X-------------------XXSSSS
--XXXXX---[]---[]-------X--------[]---XXXXX----XXXXX-------------XXXXXXX---X---------------------------------XX----X-----------------XX-SSSS
XXX---X---[]---[]------E-X-------[]-XXX----X-XXX----X----------XXXXXXXXX----X---------------------------XXXXXX------X---------XXXXXXXX--SSSS
X<>---S---[]---XX-----<>--X-----SX-XX<>-----XX<>-----XX-------XX<>XXXXXX-----X-----------------XXXX----XXXXXXX-------X-------XX--SSSSS--SSSS
-[]-------S---------E-[]---X------XX-[]----E<>[]----<>-X-----XX-[]XXXXXX------X-----------------------XX--------------X-----XX---SSSSS------
-[]-------SB-------<>-[]----X----XX--[]---<>[][]----[]--X---XX-X[]XXXXXX-------XXX-------XXX---XXX---XX----------------X----X----SSSSS------
-[]----------------[]-[]-----XXXXX---[]---[][][]----[]---XXXX-XX[]XXXXXX-------XX-XXXXXXXX--XXXX--XXXX----------------X-XXXXX----SSSSS------
XXXXXXXXXXXXXXXXXXXXXXXXXXXXXXXXXXXXXXXXXXXXXXXXXXXXXXXXXXXXXXXXXXXXXXXXXXXXXXXXXXXXXXXXXX--XXXX--XXXX---------XXXXXXXXXXXXXX----XXXXXXXXXXX