--------------------------------------------------------------------------------------------------------------------------------------------
-XXXX---------------------------------------------------------------------------------------------------------------------------------------
-XX--X-XXX---SSSSSSSSSSSSSSSS-------------SSS--<>SSSSSSSSSSSSSSSSS-------------------------------S---------------------------------------SSS
XX----XX--X--SSSS------------------------------[]SSSSSSSSSSSSSSSSS-------------------XXXXXXXXXX--S-----------------------------------------S
X----------X-SSSS------------------------------[]SSSSSSSSSSSSSSSSS------------------XX-----------S-----------------XXXX--------------------S
X-----------XSSSS-------------XX--XXXXX--------[]SSSSSSSSSSSSSSSSS-----------------XXX-----------S--------------XXXX---X------XX-----------b
X------E-----X---------------XX-XXX----X-------[]SSSSSSSSSSSSSSSSS----------------XXXX-----------S-------------XXXXX----X----XX-X----------B
S-----<>------X-------------XX--XXX-----X------[]SSSSSSSSSSSSSSSSS---------------XXXXX-----------S------------XX---------X--XX---X----------
------[]------oXXX------XXXXX------------X------SSSSSSSSSSSSSSSSSS--------------XXXXXX-----------S--------XXXXX-----------XXX-----X---------
------Xo-----S?SS-X----XX-XXX-------------XXXXX-BSSSSSSSSSSSSSSSSS--------E----XXXXXXX-----------S-------XX-XXX-----------XXX------X--------
-------Q-----SSS---X--XX-----------SSS-S--S-SSSSSSSSSSSSSSSSSSSSSS---E---<>---XXXXXXXX----<>-----S------XX-------------XXX----------X-------
-------X-----SS-----XXX------------SSS-S--S-SSSSSSSSSSSSSSSSSSSSSS--<>---[]--XXXXXXXXX----[]-----S-----XX----------------------------X----XX
-------B-------E-EE--XX------------SSS-S--S-SSSSSSSSSSSSSSSSSSSSSS--[]---[]-XXXXXXXXXX----[]-----SXXXXXX----------------------------X-XXXXX-
XXXXXXXXXXXXXXX-XXXXXXX---------XXXSSS-S--X-XXXXXXXXXXXXXXXXXXXXXX--XX---XXXXXXXXXXXXXXXXXXXXXXXXXXXXXXX------------------------XXXXXXXXXXX-