-----------------------------------------------------------------------XXXXXX---------------------------------------------------------------
-------------------------------------------------------------------XXXXX----XXXXXXXXXXXXXXXXXXXXXXXXX---------------------------------------
SSSSSSSSSSSSSSSSSSSSSSSSS?SSSSSSSSSSSSSSSSSSSSSSSSS-----SSSSSSSS--XX--X-------SSSSSSSSSSSSSSSSSSSSSSS---------------------------------------
S<>SSSSSSSSSSSSSSSSS------SSSSSSSSSSSSSSSS-------[]--------------XX---X--------------------------[]-----------------------------------------
S[]SSSSSSSSSSSSSSSSS------SSSSSSSSSSSSSSSS-------[]-------------XX-------------------------------[]-----------------------------------------
S[]SSSSSSSSSSSSSSSSS------SSSSSSSSSSSSSSSS-------[]------XXXXXXXX--------------------------------[]-----------------------------------------
-[]--------------------XXXXX---------------------[]------XSSSSSSS-X--------X---------------------[]----------X--EX--------------------------
-BX----XXXXX------XXXXXX----X--------------------[]------XSSSSSS---------------------------------<>----------X---X--------------------------
XXXXXXXX----XXXXXXXE--<>-----X------XXXXXXX------[]---XXXXSSSSS---------------------------E------------X---X-X---X--------X-EE----X---------
SSSSSSS?----SSSSSSSS--[]------X--XXXX-<><>-X-----[]--XX--?SSSS---------------------------<>------------XSSSX-XSS?X--------XSSSSSSSX---------
----------------------[]-------XXXXXX-[][]--X----<>-XX-----------------------------------[]-----S-S-S---------------------------------------
---------<>-----------[]-------EEXXXX-[][]---X-----XX-----------------X-------oooooooo---[]-----S-S-S-----------------XXX-------------------
---------[]-----------[]------E-XXXXX-[][]----XXXXXX--------------------------oooooooo---[]-----S-S-SXXXXXXXXXXXXXXXXXX--XXXXXXXXXXXXXXXXXXX
XXXXXXXXXXXXXXXXXXXXXXXXXX-XXXEXXXXXX-XXXXXXEXXXXXXX----XXXXXXXX--------------XXXXXXXX---[]-----S-S-SXXXXXXXXXXXXXXXXXX--XXXXXXXXXXXXEEXEXXX