--------------------------------------------------------------------------------------------------------------------------------------------
-------------------------------------------------------------------------------------------XX-----------------------------------------------
-SS------------------XXXX-----------------------------------------------------------------XX-XXX--------------------------------------------
-[]-------------------[]-----------------------------------------------------------------XX--XX-X-------------------------------------------
-[]-------------------[]----------------------------------XXXXXXXXXX--------------------XX---XX--X------------------------------------------
-<>-------------------[]---------------------------------XX----X----X-------------------XS---XX---X-----------------------------------------
----------------------[]--------------------------------XX-E---E-----X------------------X----XX----X----------------------------------------
--E-------------------[]------------------------------XXX-------------X--------------XXXX----XX-----X---------------------------------------
XXX-------------------[]------XXXX-------------------XX-E--------------X------------XX--X----XX------X-------------Q--?-----------------E---
<>-X-QQQQQQ?QQQQQQ?Q--<>-----XXX--X-----------------XX------------------X----------XX---SS---XX-------X---------Q-E------ESSS----EE----<>---
[]--X-----------------------XX-X---X---------------XX---------------<>---X-------XXX---------XX--------X----------E-------------<>----------
[]---X---------------------XX--X----X-------------XX----------------------X-----XX<>---------XX---------X-----------------------------------
[]----XXXXXXXXXXXXXXXXXXXXXX--EX-----XXXXXXXXXXXXXXX---------------oooo----XXXXXX-[]---------XX--------X-XXXXXXXXXXXXXXXXXXXXXXXXXXXXXXXXXXX
XXXXXXXXXXXEEXXXXEXEXXXXXXXXXXXX-----XXEXXXXXXXXXXXX--------------XXXXXXXXXXXXXXXXXXXXXXXXXXXXXXXXXXXXXXXXXXXXXXXXXXXXXXXXXXXXXXXXXXXXXXXXXX