--------------------------------------------------------------------------------------------------------------------------------------------
--------------------------------------------------------------------------------------------------------------------------------------------
SSSSSSSSSSSSSSSSSSSSSSSSSSSSSSSSSSSSSSSSSSSSSSSSSSSSSSSSSSSSSSSSSSSSSSSSSSSSSSSSSSSSSSSSSSSSSSSSSSSSSSSSSSSSSSSSSSSSSSSSSSSSSSSSSSSSSSSSSSSS
-----------------------------------SSSSSSSSSSSSSSSSSSSSSSSSSS---[]---------------------------------------------SSSSSSSSSSSSSSSSSSSSSSSS-----
-----------------------------------SSSSSSSSSSSSSSSSSSSSSSSSSS---[]-------E--------------XXX--------------------SSSSSSSSSSSSSSSSSSSSSSSS-----
-----------------------------------SSSSSSSSSSSSSSSSSSSSSSSSSS---[]---QQQQQQ-------XXXXXXX--X-------------------SSSSSSSSSSSSSSSSSSSSSSSS-----
-------XXXXXXXX------------------------------------S----SS------[]---------------XXSSSSSS---XXXXX-----------------------------------------XX
------XX-SSSSS-X-----------------------------------S----SS------[]--------------XX-SSSSSS--SSSSS-X------------------------XXXXX------XXXXXX-
-----XX--SSSSS--XXXXXXXXXXXXXXXXXXXXXXXXXXXXXX-----So???SS------[]--XXXXXXXXXXXXX--SSSSSS--SSSSS--XXXXXXXXXXXXXXXXXXXXXXXXX----XXXXXXXE--<>-
---XXX---SSSSS?SS?SSSSSSSSS????????SSSSSSSSSS-X----SSS--SS------<>-XXSSSSSSSSSSSS--SSSSSS--SSSSS?SS?SSSSS??????SSSSSSSSSSS?----SSSSSSSS--[]-
E-XX<>-----------SSSS--SSSSSSSSSSSS------------X-----------------QXX-SSSSSSSSSSSS------------------SSSSSSSSSSSS--------------------------[]-
-XX-[]-----------SSSX--SSSSSSSSSSSS-------------X--------EXXXX---XX--SSSSSSSSSSSS--------<>--------SSSSSSSSSSSS-------------<>-----------[]-
XX--[]-------------------------------------------XXXXXXXXXX-X-XXXX---SSSSSSSSSSSS--------[]---------------------------------[]-----------[]-
XXXXXXXXXXXXXXXXXXX-XXXX-X-XXXXXXXXXXXXXXXXXXXXEXXXXXXXXXXX-X-XXXX---XXXXXXXXXXXXXXXXXXXXXXXXXXXXXXXX-XX-XXXXXXXXXXXXXXXXXXXXXXXXXXXXXXXXXXX