--------------------------------------------------------------------------------------------------------------------------------------------
--------------------------------------------------------------------------------------------------------------------------------------------
S--------XXXX-----------------------------------------------------------?-----------------------------------------SSSSSSSSSSSSSSSSSSSSSSSSSS
-XXXXX--XX---X---------------------------------------------------------------------------------------------------------[]-------------------
XX----XXX-----XXXXXX-------------------------------------------------------------------------------XXXX----------------[]-------------------
XX-----X-------X----X----------------------------------SSSSS-------------------XXXXX--------------XXXX-X---------------[]----oooooo---------
XX----XX------XX-----X----------------------------------------------------SS--XX----X------------XXXXX--XB-------------<>-------------------
XXXX------------------X------------------------------------------------------XXX-----X----------XXXXXX---X------------------SSSSSSS---------
XX---------------------XXXXX----------------------------E-------------SS----XXXX------X--XXX---XXXXXXX----X-----------------SSSS--So--------
XX----------------------XXX-X------------------XXXX---SSSSSS-XXX-----------XXXXX--S----XXXS-X-XXXXXXXX--S--X----------------SSSS--SS--------
XX----------------------XXX--X----------------XX<>-X--------XXX-X--B------XXXXXX--------X----XXXXXXXXX------X-------------------------------
XX-E-------------------XXXX---X------------B-XX-[]--X------XX-X--X-b----XXXXXXXX--------SS-SSXXXXXXXXX-------XX-------XXX-----------XXXXX---
XX<>------------------XXXXX----XXXXXXXXXXXXXXX--[]---XXXXXXX--X---XXXXXXX-XXXXXX----X---SS-SSXXXXXXXXX-------X-XXXXXXXX--XXXXXXXXXXXX----XXX
XX[]------------------XXXXXXXXXXXXXXXXXXXXXXXXXXXXXXXXXXXXXXXXXXXXXXXXXXX-XXXXXXXXXXXXXXXXXX-XXXXXXXXXXXXXXXXXXXXXXXXXX--XXXXXXXXXXXX---XXXX