--------------------------------------------------------------------------------------------------------------------------------------------
--------------------------------------------------------------------------------------------------------------------------------------------
X------------------------------------------------------------------------------------------------------------------------------------------S
X------------------------------------------------------------------------------------XXX----------------------------------------------------
X----------------------------------------------------------------------------------XXX--X--------------------------------------------------S
X-----------------------------------------------------------XXXX------------------XXXX---X-------------------------------------------------B
X-----------------------------------------------------------X<>-X---------E------XXXXX----X-------------------------------------------------
X-----------------------------------------------------------X[]--X--------------XXXXXX-----X------------------------------------------------
X----------X-EE-----X-------------ooo-----------------E----XX[]---X----XXXX----XXXXXXX------X------------------B-------------------------XXX
X----------XSSSSSSSSX-------------ooo---------------------XXS[]----X--XX---XX-XXXXXXXX-------X---------B-------b------------------------XX<>
--------------------------------------------------oo-----XX--[]-----XXX----X-XXXXXXXXX--------X--------b--?-B------?QQ-----------------XX-[]
-------XXX----------------------------------------oo----XX---[]------X-----XXXXXXXXXXX---------X-------B----b------------XXX----------XX--[]
XXXXXXXX--XXXXXXXXXXXXXXXXXXXXXXXXXXXXXXXXXXXXXXXXXXXXXXX----[]------B-----XXXXXXXXXXX--------X-XXXXXXXXXXXXXXXXXXXXXXXXXX--XXXXXXXXXXX---[]
XXXXXXXX--XXXXXXXXXXXXXEEXEXXXXXXXXXXXXEEXEXXXXXXXXXXXXXXXXXXXXXXXXXXX-----XXXXXXXXXXXXXXXXXXXXXXXXXXXXXXXXXXXXXXXXXXXXXXX--XXXXXXXXXXXXXXXX