--------------------------------------------------------XXX---------------------------------------------------------------------------------
-----------------------------XXXXXXXXXXXXXXXXXXXXXXXXXXXX--X---------------------------------------------------------XXXXXXXXXXXXXXXXXXXXXXX
-----------------------------XXXXXXXXXXXXXXXXXXXXXXXXXXXX---X-------------SSSSSSSSSSSSSSSSS?SSSSSSSSSSSSS----------XXXSS????SSSSSSSSSSSSSSSS
----------------------------XXXXXXXXXXXXXXXXXXXXXXXXXXXXX----X--------------[]----------------------SSSSS-------XXXXSS----------------------
X-XXXXX--------------------XX-XXXXXXXXXXXXXXXXXXXXXXXXXXX-----X-------------[]----------------------SSSSS-------XSSS------------------------
XXXXXX-X-------------------XS-XXXXXXXXXXXXXXXXXXXXXXXXXXX------X------------[]----------------------SSSSS-------X---------------------------
XXXXXX--X------------------X--XXXXXXXXXXXXXXXXXXXXXXXXXXX-------X-----------<>-------------XXXXX----SSSSS------XX---------------------------
XXXXXX---X----------------XX--XXXXXXXXXXXXXXXXXXXXXXXXXXX--------X--------------------XXXXXX----X---SSSSS-----XXS---------------------------
XXXXXX----X--------------XXS--XXXXXXXXXXXXXXXXXXXXXXXXXXX---------X------------------XXXXXXX-----XX-SSSSS---XXX-------XXXXX-----------------
XbXXXX-----X------SSS----X----XXXXXXXXXXXXXXXXXXXXXXXXXXX----------X----------------XXXXXXXX----<>-X---SS--XX<>------XXXXXX-----------------
XbXXXX------X-----------XX----XXXXXXXXXXXXXXXXXXXXXXXXXXX-----------X--------------XXXXXXXXX----[]--X--SS-XX-[]----EXXXXXXX------------XXX--
XXXXXX-------XXX-------XX---E-XXXXXXXXXXXXXXXXXXXXXXXXXXX------------X-----XXX----XXXXXXXXXX----[]---X-SSXX--[]----XXXXXXXX---XXX-----------
XBXXXX-------XX-XXXXXXXX------XXXXXXXXXXXXXXXXXXXXXXXXXXX-----------X-XXXXXX--XXXXXXXXXXXXXX----[]----XXXX---[]---XXXXXXXXX-----------------
XXXXXXXXXXXXXXXXXXXXXXXXXXXXXXXXXXXXXXXXXXXXXXXXXXXXXXXXX--XXXXXXXXXXXXXXXXX--XXXXXXXXXXXXXX--XXXXXXXXXXXXXXXXXXXXXXXXXXXXXX----------------