S-------------------------------------------------------------------------------------------------------------------------------------------
S-------------------------------------------------------------------------------------------------------------------------------------------
-SSSSSSSSSSSSSS--------------SSS------ESSSSSSSSSSSSSSS--------------------------------------------------------------------------------------
--------------------------------------QSSSSSSSSSSSSSSS--------------------------------------------------------------------------------------
--------------------------------------?SSSSSSSSSSSSSSS----------------------------------------------------------------------------------X---
X---------------XX--XXXXXX------------BSSSSSSSSSSSSSSS----------------------------------------------------------------------------------XXXX
-X-------------XX-XXX-----X-----------XSSSSSSSSSSSSSSS------S-------------X---EX--------------------------------------------------------X<>-
--X-----------XX--XXX------X----------oSSSSSSSSSSSSSSS---------------X----X----X--------------------------------------------------------X[]-
---X------XXXXX-------------X-----X----SSSSSSSSSSSSSSS---------------X--X-X----X--------X-EE----X-------------ooo-----------------E----XX[]-
-S?-X----XX-XXX--------------XXXXX-XXX-SSSSSSSSSSSSSSS----------SSS--XSSX-XSSS?X--------XSSSSSSSX-------------ooo---------------------XXS[]-
-SS--X--XX-----------SSSS-S--SSSSSSSSSSSSSSSSSSSSSSSSS----------SS------------------------------------------------------------oo-----XX--[]-
-SS---XXX------------SSSS-S--SSSSSSSSSSSSSSSSSSSSSSSSS--<>------SS------------------XXX---------------------------------------oo----XX---[]-
XSSE---XX------------SSSS-S--SSSSSSSSSSSSSSSSSSSSSSSSS--[]----XXXXXXXXXXXXXXXXXXXXXXX--XXXXXXXXXXXXXXXXXXXXXXXXXXXXXXXXXXXXXXXXXXXXXX----[]-
XSX-XXXXX---------XXXSSSS-S--XXXXXXXXXXXXXXXXXXXXXXXXX--XX---XXXXXXXXXXXXXXXXXXXXXXXX--XXXXXXXXXXXXEEXEXXXXXXXXXXXXEEXEXXXXXXXXXXXXXXXXXXXXX