--------------------------------------------------------------------------------------------------------------------------------------------
--------------------------------------------------------------------------------------------------------------------------------------------
-----------------SSSSSSSSSSS----------------------------------------------------------------------------------------------------------------
--------------------------------------------------------------------------------------------------------------------------------------------
---------------------------------------------------------------------------------------------------------------------------XSXSXSXSX--------
-----------------------------------SSS----SSSSSS-------S---------------------------------------------------------Q--------------------------
---SX---------------------------------------------------------------------------------------------------------------------------------------
-XXXX---------------------------------------------------------------------------------------------------------------------------------------
----------E-----------------------------------S------------------------------E--------------------------------------------------------------
X-X------X---SSQ-----E---QQQ<>----XXXXX---------------<>--------------------<>-------------------------S--------S-SSXS----------------------
X-X--------B--------<>------[]------------------------[]---E------E---------[]--XXXX--------------------------------------------------------
XXX-SSS--Xo--<>-----[]------[]------------------------[]---B-----<>---------<>---------------------------------------------------------XX---
XXXSSSX--XS-<>-----S[]------[]----S-----------E-------[]--<>--E--[]---------[]---------------------------------------------E-E-E-E-----XX---
XXXXXXXXXXXXXXXXXXXXXXXXXXXXXX-XXXX------XXXXXXXXXXXXXXXXXXXXXXXXXXXXXXXXXXXXXX-----XX---XXXXXXX-----XXXX-XXXXXXXXXXXXXXXXXXXXXXXXXXXX-X----