-------------E------------------------------------------------------------------------------------------------------------------------------
----------SSSSS-----------------------------------------------------------------------------------------------------------S-----------------
SSSSSSSSSSSSSSSSSSSS--------------------------------------------------------------------------------------------SSSSSSSSSSSSSSSSSS----------
--------SSSSSSSSSSSSS---------------------------------------------------------------------------------------------------SSSSSSSSSS-S------XX
--------SSSSSSSSSSSS----------------------------------------------------------------------------------------------------SSSSSSSSSSSS--------
-------SSSSSSSS--------X---X-------------------------------------------------------------------------------------------SSSSSSSS-----------XX
---------------S---------------------------------------------------------------------------------------------------------------S----------X-
------------------------XX------------------------------------------------------------XXX------------------------------------SS---------XXX-
-----------?----S------XXXXX-------------------------------------------------E-------------------SX------------------------X--SSS------XXXXX
---<>------SSSSSSSS---XXXX----------------------S-----------------------Q---<>----------------E--------------------QQ-----SSSSXSS-------XX--
---[]------SSS--------XXXX-------------------------XXE-----E----------------[]---------------------------------------------S----------X-XX--
---[]------SSS--------XXXXXX---<>---<>---------------------B----------------[]--------------------------------------------------------XXXXXX
---[]------S-----XXXX-XXXX-----[]---[]------------E-------<>--<>-EE---------[]---------------EE---------E------------------S---E---XX-X-XXXX
--XXXXXXXXXXXXXXXXXX--XXXXXXXXXXXXXXXXXXXXXXXXXXXXX-----XXXXXXXXXXXXXXXXXX--XXXXXXX-------XXXXXXXXXXX--------XXX--XXXX-XXXXXXXXXXXXXXXXXXXXX