--------------------------------------------------------------------------------------------------------------------------------------------
--------------------------------------------------------------------------------------------------------------------------------------------
----------------------------------------------------------------------------------------SSSSSSSSSSSSSSSSSSSSSSSS----------------------------
----------------------------XXXXXX----------------------------------------------------------------------------------------------------------
XXXXXXX-------------------------------SXSX--------------------------------------------------------------------------------------------------
-E------------------S---------------------------------------------X----SX---XX---S----------------------------------------------------------
XXXXXXXXX-------------------------------------------------------------------------------------------------SX--------------------------------
---------------------------------------E--XS------------------------------------------XXX---------------------------------------------------
--------------------------------E-------E-------------XX--------------------------------------E--SE-----------------------------------------
-----------XXX------------XX---<>------------------XXXXX-------------------------------------<>---------XXX---------------------------------
-----------------------E-------[]------------------XXXXX----------------------------------E--[]--------XXX---------------------E------------
---------S------------<>----B--[]---<>-----------XXXXXX--------------------------------------[]--------XXX----------------------------------
----------------------[]-------[]---[]----------XXXXXXXX------------------E------------------[]-----X--XXX-------------------------E--------
------XXXX---------XXXXXXXXXXXXXXXXXXXXXXXXXXXXXXXXXXX--XXXXXXXXX--XXXXX--XXXX--X---XXXXXXXXXXXXXXXXXXXXXXXXXXXXXXXXXXXXXXXXXXXXXXXXXXXXXXXX