--------------------------------------------------------------------------------------------------------------------------------------------
--------------------------------------------------------------------------------------------------------------------------------------------
-------------------------------------------------SSSS---------------------------------------------------------------------------------------
--------------------------------------------------------------------------------------------------------------------------------------------
-----------------------EE-E-----------------------------------------------------------------------------------------------------------------
S-----SX-----SXSX----XXXXXXX-------------------------------------------------------S-------------------------------------------------------S
-------------------------------SX-----------------------------------------------XSX-XXXXXXX--------------------------------------------SXSX-
------------------------------XXX----------------------X--------------------------------------------------------------------------------S---
----------SSXX--------------?---------E-------------------------------------------------------------------------------------------SX--------
XXXX------------------------XXX------X---SSE-----E---Q-Q---------------------------E--------------------------XX-E-------XX----------SSS----
----------------------------XXX--------Q-----XX-<>----------------XXXXXX---E------<>----------------------------<>-------------E------------
----------------------------XXX--SSS-----<>-----[]--------------------EX--<>------[]----------------------------[]--------------------------
----------------------------XXXSSSXS--S-<>------[]------------------------[]------[]----------------------XX----[]----------------EB--------
XXXXX-XX-XXXXXXX-XX---------XXXXXXXXXXXXXXXXXXXXXXXXXXXXXXXX-XXXXXX------XXXXXXXXXXX----------------------XX-XXXXXXXXXXXXXX---XXXXXXXXXXXXXX