--------------------------------------------------------------------------------------------------------------------------------------------
--------------------------------------------------------------------------------------------------------------------------------------------
--------------------------------------------------------------------------------------------------------------------------------------------
--------------------------------------------------------------------------------------------------------------------------------------------
--------------------------------------------------------------------SX----------------------------------------EE----------------------------
-------------------------------------------------------S------------SX----Q-----------SSS------------X------SXXX----------------SSS---------
---------------------------------------------------SX-------------------------------E-S----------------------------SX-----------------------
----------------------------------------------------S--X------------------------------------------------------------------------------------
X-X------------E-------------------------------------------<>-------E---------------SSS--------SX--XXXX------------------------------E------
---------------------XXXX---------------------QQQSSS--E----[]-----------QQQ-S--X-X--XXXX------------------------------<>-------SSS--Q----XXX
----------------------------E------------------------<>-B--[]--------E---------XXXX-----------------------------------[]------S-SX------XXXX
-----------------------------S-----------------------[]-S--[]------SS---------XXXXX-------------------------------X---[]-----S----------XXXX
---------------------------XESEE--E---E--------------[]----[]----E-------E--EEX--XX----X-E------------------------X---[]----E-------E----XXX
----------------------------XXXXXXXXXXXXXXXXXXXXXXXXXXXXXXXXXXXXXXXXXXXXXXXXXXX--XX-XXXX-----------XXXXX-------XXXXXXXXXXXXXXXXXXX-XXXXXXXXX