--------------------------------------------------------------------------------------------------------------------------------------------
--------------------------------------------------------------------------------------------------------------------Q-----------------------
------------------------------------------------------------------------------------SSSSSSSSSSSSSSSSS-SSSSSSSS------------------------------
----------------------------XXXXXXX---------------------------------------------------------------------------------------------------------
----------------------------------------------------------------------------------------------------------------S----------------------E----
-----------------------------------------------------------------------------------------------------------XX----------------SSSS-----------
-----------------------SXXXX-----X------------------------------------------------------------------------------ES--------------------------
---------------------------X-------------------------------------------X--------------------------------------------------------------------
--------------------------------------------------------X-X------------E----------------------------------------SSS------S-SSS-SSS----------
-------------------SSSSS----------------------------------------------------------------------------------X---S-X-----XXXXS---S-------------
<>-------------E---------------------E------------XXXXX---------------------------------------------------XX--------------------------------
-B---------X------------------------<>-----------XXXX-----SX-----XXXXXXX----------------------------------XX-----------------------------XXX
ES--------EXX-----------------------[]-----------XXXXX----------------------EE---------------E------XXXXX-XX---------E----------------------
XXXXXXXXXXXXXXXXXXXXXXXXXXXXXXXXXX--XX-------XXXX-XXXXXXXX---------------XXXXXX---XXXXXXXX--XXXXXXXXXXXXXXXXXXXXXXXXXXXXXXXXXXXXXXXXX---XXXX