--------------------------------------------------------------------------------------------------------------------------------------------
--------------------------------------------------------------------------------------------------------------------------------------------
-----------------------------------------------S-SSS----------------------------------------------------------------------------------------
--------------------------------------------------------------------------------------------------------------------------------------------
--------------------------------------------------------------------------------------------------------------------------------------------
-----------------------------------------Q--E?SS-----------SSSS-------Q---------SSSS--------------------------------------------------------
-----------------------SXXX----SX-----------------------------------------------------------------------------------------------------------
-----------------------------------E--------------------------------------------------------------------------------------------------------
----------------------------------<>-------------E------------------X-------------------E-------E-------------------------E-----------------
----------------------------------[]---S---SS?S-<>---E----XX-X-------------------------<>--------------SS-----E---X-----------SE-----E------
---------------E--------------<>--[]----SSS-SX--[]------------------X---------------E--[]--------------------<>-X-X-----------------<>--E--X
------------------------------[]--[]---SSS------[]----------------------------------X--[]--------------------[]-XXX--SS-------------[]------
-------------------E--------X-XB--[]------------[]-----------E-------------------SS--E-[]---SE----E-E----EE--[]-XXX--SX---E-E-------[]-----X
XXX---XXXX-------XXXXXXXXXXXXXXXXXXXXXXXXXXXXXXXXXXXXXXXXXXXXXX----X------------XX-XXXXXXXXXXXXXXXXXXXXXXXXXXX--XXXXXXXXXXXXXXXXXXXXXXXXXXXX