-----------------------------------------E--------------------------------------------------------------------------------------------------
--------------------------------------SSS---------------------------------------------------------------------------------------------------
----------------------------SSSSSSSSSSSSSSSSSSSS-----SSS----------------------------------SSSSSSSSSSSSSSSSSSSSSS------------------SSSSSSSSSS
----------------------------------SSSSSSSSSSSSSSS-------------------------------------------------------------------------------------------
-----------------------------------SSSSSSSSSSSSS--------------------------------------------------------------------------------------------
------------------------------------SSSSSSSSSSSS---X---X------------------------------------------S-----------------------------------------
----------------------------------------------------------------------------------------------------------SX--------------------------------
----------------------------------------------------X--------------------------------XXXX---------------------------------------------------
---------------------------------------??---S------XXXSX-----------------------------------------SX-----------------------E----------E------
-------------------------------------SSSSSSSSSS---XXX-------E--------------QQQ---<>-----------?----------XX--------------<>--<>E----XX---Q-Q
--------------------------X------------SSS--------XXX---E--<>--------------------[]----------<>---------X----------------[]--[]----XXB------
---------------------------------------SSSS-------XXXXXX---[]--------------------[]----------[]--------XX---------X------[]--[]-----<>------
-------------------------------E-------S-SS----<>-X-XX--E--[]--------------------[]----------[]-----X--XX---X-----X---E--[]--S--X---XX------
XXXXXXXXXXXXXXXXXXXXXXXXXXXX---XXX-XXXXXXXXXXXXXXXXXXXXXXXXXXXXXXXXXXXXXXXXXXXXXXXXX--XX-XXXXXXXXXXXXXXXXX---XXX-XXXXXXXXXXXXXXXXXXXXXXXXXXX