--------------------------------------------------------------------------------------------------------------------------------------------
--------------------------------------------------------------------------------------------------------------------------------------------
--------------------------------------------------------------------------------------------------------------------------------------------
--------------------------------------------------------------------------------------------------------------------------------------------
--------------------------------------------------------------------------------------X---------------------------------E------------------E
--------------------------------------------------------SSSSS------SXSX-----------S-------------------------------SSSSS----------X----------
------------------------------------------------------------------------------------XXXXXXXXX------------------------------E--XXXX--------SS
--XXX----------------------------------------------------------------------------------------------------------------------------X----------
-------------------------------------------------E------------------------------------------------------------------------------SXXX--------
XXX------------Q--------------------------------<>------------------------------------------------------------XX---X-XXX--------------------
XXX---------------E-E---E-------------E---------[]-----------------------------------------------------------------------XXXXXXX------------
XX------------------B----------------<>---------[]---------------------------------------------------------------X-X----SXXXX---------------
XXX---S-----E--------------E--E---E--[]---------[]-----------------------------------------------------------------X-E-SSXXXXX-----------EEE
X---XXXXXXXXXXXXXXXXXXXXXXXXXXXXXXXXXXXXXXXXXXXXXXXXXXXX---------------------------XX------------X-----XXXXXXXXXXXXXXXXXX------XXXXXXXXXXXXX