--------------------------------------------------------------------------------------------------------------------------------------------
--------------------------------------------------------------------------------------------------------------------------------------------
--------------------------------------------------------SSSSSSSSSSSSSSSSSSSSSSSSSSSS--------------------------------------------------------
--------------------------------------------------------------------------------------------------------------------------------------------
------------------------E-EE----------------------------------------------------------------------------------------------------------------
--SSSXSX---------X------SXXSSSS--------SX-----EXS-------X--S--------EQ--SS----------S-----------SS----------XXXX----------------------------
S--------------------------------------------XXX-----------SX-------------------------------------------------------------------------------
--------------------------------------------------------------------------------------------------------------------------------------------
SSS--------SX---SX----------------------SX--------------------<>--E----------E----------------SSSS------------------------------------------
XXXX-X----------------------XQQ---------X----------XXX--------[]-<>--SBSSX--<>---E--XQXQ----------------------------------E-----------------
--------------------------------------------------------E-<>---?-[]-SSS--X-X[]---XXE-------------------------------------<>----------X------
----------------------------------------------------------[]-----[]--SS-----[]X------------------------------XXX---------[]---------<>------
---X-E-------------------S--------------------------------[]--<>-[]--SS-XX--[]X--------------------E---------------------[]---------XX------
XXXXX---------------------------------------------------XXXXXXXXXXXXXXXXXXX-XXXXXXXXXXXXXXXXXXXXXXXXXXXX--------XXXXXXXXXXXXXXXXXXXXXXXXXXXX