--------------------------------------------------------------------------------------------------------------------------------------------
--------------------------------------------------------------------------------------------------------------------------------------------
------------------SSSSSSSSSS----------------------------------------------------------------------------------------------------------------
--------------------------------------------------------------XX----------------------------------------------------------------------------
------------------------------------------XXXXXX------------------------------------------------------------------------------XXXX----------
---S------------E?------------------------------X--------------------------------------SSSSSS----------------------------------------XSX----
---SX------------------------------------------------------X--------------------------------------------------------------------------------
-------E----------------------------E-------------------------------------------------------------------------------------------------------
------<>--E----------E-------------------------------------------------E----------------------------SXS-------------------------------------
------[]-<>--S-EEX--<>---E--S-S-SSSSS-----------------------------E---------XX------<>---XXXXX-----------------E----------------------------
--<>--[]-[]--<>--X--[]-----E-------------------------------------<>---------XX------[]------------------------<>-----------------------E----
--[]--[]-[]--SS-----[]-----------------------------<>------------[]--XXX----XX------[]------------------------[]----------------------<>----
--[]--[]-[]---S-----[]-------------------E--E------[]------------[]-----X---XX------[]------------------------[]-------------E--EE----[]----
XXXXXXXXXXXXXXXXX---XXXXXXXXXXXXXXXXXXXXXXXXXXXXXXXXXX--XXXXXX---X--------XXXXXXXXXXXXXXXXXXXX----XXXXXXXXXXXXXXXXXXX--XXXXXXXXXXXXXXXXXXXXX