--------------------------------------------------------------------------------------------------------------------------------------------
--X-Q---------------------------------------------------------------------------------------------------------------------------------------
-----------------SSS-------S----------------------------------------------------------------------------------------------------------------
------Q--E----------------------------------------------------------------------------------------------------------------------------------
SS------<>-S-SSS-----------------------------------------------------------------------------------SXSXS------------------------------------
-----E?S?SSS--SS?--Q----------------SSSSSSSSSSSS--------SSS---------------EX----------------------------------------------------------------
-SSSX--------------------------------------------------------------------XXX------------------------------------------------------------SX-X
-XXXXX--------------------------------------------------------------------------XSX---------------------------------------------------------
SX---------SXS--X-------------------------------------E-------------------------------------------------------------------------------------
XX----XXX---S--QS-----------X--------SXS-SSSSSS-------E-SSSQS------X------------X-------S?SSS--------------------------------------SSS------
--------------------E---------------------------------<>---------------------X--X-X---------------------------------------------------------
X---S--------------<>--------------------------------S[]---------------------X--XXXX------------------------BSS-----------------------------
X--SSS------E--------------XE--------------E----------X----------------------X--X----E-----------E-EE-EE---<>-------------EXE---------------
X---XXXXXXXXXXXXXXXXXXXXXXXXXX--XXX------XXXXXXXXXXXXXXX------XX------------X-------XXXXXXXXX-XXXXXXXXXXXXXXXXXXXXXXXXXXXXXXXXXXXXXXXXXXXXXX