--------------------------------------------------------------------------------------------------------------------------------------------
--------------------------------------------------------------------------------------------------------------------------------------------
--------------------------------------------------------------------------------------------------------------------------------------------
----------------------------X---XXXX--------------------------------------------------------------------------------------------------------
-----------------------EE-E-----------------------------------------------------------------------------------------------------------------
S-S---SX----XSXSX---XXXXXXXX---------------------------------------------X--------------------------------------X---------SSSQ--E?SS--------
------------------------------XXXE----------------------------------------------------------------------------------------------------------
-----------------------------------------------------------------------X-X------------------------------------------------------------------
-----------XX----------------------------------------------------------E----------------------------------------?-------------------------EX
XXXX----------------------------------E--XXX----XXXXXXX------------------------------------------X----------XXXXX---E-<>---?S---S?SQQQQ--<>-
-------------------------------------EB----------XX---------------XXXX---------------------------------------------<>-[]-----------------[]-
-------------------------------------------X----XX---------------XXXXX---------------------------------------------[]-[]---S-------------[]-
--------------------------------------------X-XXXXXXX-----------------------------EE----------------------------E-<>--[]---------E----E--[]-
XXXXX------XXXX--------------XXXXXX-XX-----------------XXXXXXX----------XXXXXXXXXXXXXXXXXX--XXXXXXXXXXXXXXXX-XXXXXXXXXXXX-XXXXXXXXXXXXXXXXXX