--------------------------------------------------------------------------------------------------------------------------------------------
--------------------------------------------------------------------------------------------------------------------------------------------
--SX----------------------------------------------------------------------------------------------------------------------------------------
--------------------------------------------------------------------------------------------------------------------------------------------
--------------------------------------------------------------------------------------------------------------------------------------------
SSS--------------------------------SS-----SSSS?S--------------------------------------------------------------------------------------------
---------------------------------------------------------------------------XX---------------------------------------------------------------
------------------------XXX--E---------------------------------------------------------------------X-X--------------------------------------
--------------S-------------XX---------------------------------------X----------------------------------------------------------------------
SSQQQQ-------S--------------XB----<>-------QSSS--SS-----------------X---------XXX---------------------------------------------S-------------
------------------------X---X?----------------S---------------------------------X-------------X-XXX?-----------B----------------------------
-----------------------XXXXX<>----SS-----------------------------------------------------------XX-X------------X----------------------------
-----------E-E-E--------X---XB----XS--------------------------------------------------------------------------XX---------------E------------
XXXXXXXXXXXXXXXXXXXXXX------XXXXXXXXXXXXXXXXXXXXXXXXXXXX--------XXX----------------------------------------XXXXXXXXXXXXXXXXXX-XXXXXXX---X---