--------------------------------------------------------------------------------------------------------------------------------------------
--------------------------------------------------------------------------------------------------------------------------------------------
----------------------------SSXSXSXSXS--S-SSS-----------------------------------------------------------------------------------------------
--------------------------------------------------------------------------------------------------------------------------------------------
-----------------------EE-E----------------------------------------------SXS----------------------------------------------------------------
S------------SXSX---XXXXXXXX----------------------XXXX--SSS--------X----X---XXXX-E--SSS--------XX--SX--XXXXXXXXXX--S------------------------
--------------------------------------------------------------------------------------------------------------------------------------------
-----------------------------------------S--------------------------------------------------------------------------------------------------
-----------SX---------------------------SSSSS------X---------------------------------------------------------------------------------E------
XXXX--------------------------------------------------SXSQ--QQQS--------------------X-------------------------------E-----------Q---<>---E--
----------------------------------------------------------------------------------------------------------------E--<>-----E--E------[]---XX?
-------------------------------------------------------------------------------------------------------------------[]----<>---------[]------
-----------------------------------------------------------------------E-EE----------------------------------------[]-EB-[]------E--[]------
XXXXXXXXXXXXXXXX-XX---------XXXXX----XXXXXXXX----------XXXXXXXXX---XXXXXXXXXXX----------------------------------XXXXXXXXXXXXXXXXXXXXXXX--XX-