--------------------------------------------------------------------------------------------------------------------------------------------
--------------------------------------------------------------------------------------------------------------------------------------------
-------------------------------------------------------------------------------------------SX-----------------------------------------------
---------------------------------------------------------XXX-E------------------------------------------------------------------------------
--------E---------------E-EE--------------------------------XXX-----SXSX--------------------------------------------------------------------
--SSS------------X------SXSS-------------Q--E?SS----------------------------------------------------------------SSS---------XS--------------
E-S--------E-----X--------------------------------------------------------------------------------------------------------------------------
--------------------------------------------------------------------------------------------------------------------------------------------
SSS--------SX--XXXX----------------B------------------E-----------------------------------------SSSSS-----------------------S---------------
XXXX-X-X--------------------------<>---E----S?SQQQQ--<>-----X---------------------X-------------------------X---XQQQQQQ------SS-------------
------------X-----------------<>E-[]-----------------[]----------E-------------XXXX-------------------------X-------------------------------
---X--------------------------[]--[]---S-------------[]-X-------<>------------XXXXX----------------------------X------------------------XSXX
---XSE----------------------X-[]--[]-----------------[]---E-E---[]-----------XXXXXX----------------------------X---------------E-EE---------
XXXXXXX----XXXXXXXXX-XX-----XXXXXXXXXXXXXXXXXXXXXXXXXXXXXXXXXXXXXXXXXXXXXXXXXXXXXXXXXXXXXXXXXXXXXXXXXXXXX---XXXXXXXXXXXXXXXXXXXXXXXXX-------