--------------------------------------------------------------------------------------------------------------------------------------------
--------------------------------------------------------------------------------------------------------------------------------------------
--------------------------------------------------------------------------------------------------------------------------------------------
--------------------------------------------------------------------------------------------------------------------------------------------
------------------------------------------XSXSX-----------------------------------------------------------------XXXXXX---------SX-----------
----------------------------------------------------------------------SSSSSS-----------SSSS----------X--------------------XXX-------XX---SS-
--------------------------------------------------------------------------------------------------------------------XXXXX-------------------
---------------------------X--------E-------------------------------------------------------------------------------------------------------
---------------------E------------------------------------------------------------------------------SXSX------------------------------------
------<>--------Q--QQQ----------SSSSS-------------------X-----<>---S---SSSS---Q------Q---XXXX---------------------------------------------XX
------[]-----------------EE---------------------------X-------[]--------SS----------<>------------------------------------------------------
--X---[]-------------E--------------X---------------XXX-------[]--------------------[]-------------------------------------------------S----
E-X---[]--E-E--------------------------E-E---------XXXX-X-----[]--------------------[]------------------------EE----------------------------
XXXXXXXXXXXXXXXXXXXXXXXXX---XXXXXXXXX----XXXXXXXXXXXXXXXXXXXXXXXXXXXXXXXXXXXXXXXXXXXXXXXXXXXXXXXXX-XXXXXXXXXXXXX-------------X-----XXXXXXX-X