--------------------------------------------------------------------------------------------------------------------------------------------
--------------------------------------------------------------------------------------------------------------------------------------------
--------------------------------------------------------------------------------------------------------------------------------------------
----------SSSSSSSSSS------------------------------------------------------------------------------------------------------------------------
----------S-SS-----S------------------------------------------------------------------------------------------------------------------------
--------SSSSSSSSSS----------------------------Q---------------------------------------------------------------------------------------------
--------------------------X-----------------------------------------------------XX-X--------------------------------------------------------
-------------------------XX--------------------------------------------------------X--------------------------------------------------------
-----------X-------------XXX----E-------E-------------XX------------------------------------------------------------------------------------
X--------SSSSSSSSS-------------<>--------------QS----XB--------------------QQS-------------------------SSS----------------------------------
--------------------------XXB--[]--------------------<>------------------------------------------------------<>-----------------------------
-----------------------XXXXX---[]------SE------------XB------------------------------------------------------[]-----------------------------
X-------------EE--------XXXXE--[]----------------EE--XX-E-EE--E--EE-E-----------------E-------------EE-E-----[]-----------------------------
----XX--XXXXXXXXXXXXXXXXXXXXXXXXXXXXXXXXXXXXXXXXXXXX-XX-XXXXXXXXXXXXXXXXXXXXXXXXXXXXXXXXXXXXXXXXXXXXXXXXXXXXXXXX----------------------------