--------------------------------------------------------------------------------------------------------------------------------------------
--------------------------------------------------------------------------------------------------------------------------------------------
SSSSSSSSSSSSSSSSSSSSSSSSSSSS----------------------------------------------------------------------------------------------------------------
X-------------------------------------------------------------------------------------------------------------------------------------------
--------------------------------------------------------------------------------------------------------------------------------------------
------------------------------------------------------------------SSSQSSSSSS------------------SXS?------------------SSS--------------------S
----------------------------------------------------------------------------------------------------------------------------------------XSXS
--------------------------------------------------------------------------------------------------------------------------------------------
----------------------------------------------------------------------------------------E---------------------E-----------------SXSX--------
----------E---------XXX---S-----------------------------X-----<>--??---SS?SQQQQ-----?--Q?--------------------XX-----------------------?S----
---------<>--------XXXX-------------------------------------E------------------------------------------------XX-<>---------XX--E------------
---------[]---------XXX---------------------------------------<>---------------------------------------------XX-[]---------X----------------
---EE-E--[]-----XX-XXXX-------------------------------XXE-----[]--------------E-----XE-EE--------EEEE----E-XXXX-[]---------X----------------
XXXXXXXXXXXXXXXXX---XXXXXXXX-----XXXX----------------XXXXXXXXX--XXXXXXXXXXXXXXXXXXXXXX-XXXXXX-XXXXXXXXXXXXXXXXXXXXXXXXXXXXXXXXXXXXXXXXXXXXXX