--------------------------------------------------------------------------------------------------------------------------------------------
--------------------------------------------------------------------------------------------------------------------------------------------
--------------------------------------------------------------------------------------------------------------------------------------------
----------------------------------------------------------------------------------------------------------------XXXXXXX---------------------
----------------------------------------SXSX-XSX---------------------------------------------------------------------------X----------------
----------------------------XQQ----S--SSSX----Q------------S-------------X------SSS---------------------------------------------------------
--------------------------------------------------------------------------------------------------------------------------------------------
-----------------------------------------------------------------------X-X----------------------------------XXX---------------------------X-
-------------------------------<>-------E-------------EX---------------X-X---------S------------------------XX----------------------------X-
----------E----------------X?--[]-----------SQQ------<>----X---------------------XX--SSSS-------------------X--------------------------XXXXX
---------<>-------------XXXXB--[]--------E-----------[]--------------------------------------------------XXXXX-----------E-----------XXXXXXX
---------[]----------------X---[]------SS-----------?[]--------------------------------------------------X-XXX--X-------<>----------XXXXXXXX
--------------------EE----XXX--[]----------E-E--E-E--XS-----------------------------------------------------X----<>-E---[]-S-------XXXXXXXXX
XXXXXXXXXXXX-----XXXXXXXXXXXXXXXXXXXXXXXXXXXXXXXXXX-XXX---X------------------XX-----XXXXXXXXX-X---XXXXXXX-------XXXXXXXXXXXX---XXXXXXXXXXX-X