--------------------------------------------------------------------------------------------------------------------------------------------
--------------------------------------------------------------------------------------------------------------------------------------------
--------------------------------------------------------------------------------------------------------------------------------------------
--------------------------------------------------------------------------------------------------------------------------------------------
----------------------------------------------------SSS-------------------------------------------------------------------------------------
--------------------------------------------S---E---------o---------------------------------------------------------------------------------
------------------B------SS------------SS-------SS-----Q--E---------------------------------------------------<>----------------------------
------------------b-----SS-----SS-----SS-------SS-----SS?-SS----SS-----o---------------------------------------<>---------------------------
------------------b------SS-----o------SS-------SS??--SSSS--SSSS--SS-------------<>-----------------<>----------<>--------------------------
----E---o--------B--------------------SSSS--<>SSSS---SSSS--SSSS---<>-------------[]-----------------[]--------------------------------------
--------------------------<>---E--------<><>[]<>-----------<><><><>-----------------------------------X---X---------------------------------
XXXXXXXXXXXXXXXXXXXXXXXXXXXXXXXXXXXXXXXXXXXXXXXXXXXXXXXXXXXXXXXXXXXXXXXXXXXXXXXXXXXXXXXXXXXXXXXXXXXXXXXXXXXXXXXXXXXXXXXXXXXXXXXXXXXXXXXXXX--
XXXXXXXXXXXXXXXXXXXXXXXXXXXXXXXXXXXXXXXXXXXXXXXXXXXXXXXXXXXXXXXXXXXXXXXXXXXXXXXXXXXXXXXXXXXXXXXXXXXXXXXXXXXXXXXXXXXXXXXXXXXXXXXXXXXXXXXXXX--
XXXXXXXXXXXXXXXXXXXXXXXXXXXXXXXXXXXXXXXXXXXXXXXXXXXXXXXXXXXXXXXXXXXXXXXXXXXXXXXXXXXXXXXXXXXXXXXXXXXXXXXXXXXXXXXXXXXXXXXXXXXXXXXXXXXXXXXXXX--