--------------------------------------------------------------------------------------------------------------------------------------------
--------------------------------------------------------------------------------------------------------------------------------------------
------------------------------o----------------------------------------------------o--------------------------------------------------------
--------------------------------------------------------------------------------------------------------------------------------------------
---------------------------------Q---------------------------------------------------------------------------------QQ-----------------------
--------------------------------------------------------------------------------------------------------------------------------------------
------------------------------o<>-----------------------------------------------------------------------------------------------------------
--------------------------------<>--------------SSS-------------------SSS-------------SSS---------------------------------------------------
--------------------------------------------------------------------------------------------------------------------------------------------
--------------------------------------------------------------------------------------------------------------------------------------------
--------------------------------------------------------------------------------------------------------------------------------------------
--------------------------------------------------------------------------------------------------------------------------------------------
-----------------------X----------------------X---------------------X--------------X-------------------------------------------------------B
XXXXXXXXXXXXXXXXXXXXXXXXXXXXXXXXXXXXXXXXXXXXXXXXXXXXXXXXXXXXXXXXXXXXXXXXXXXXXXXXXXXXXXXXXXXXXXXXXXXXXXXXXXXXXXXXXXXXXXXXXXXXXXXXXXXXXXXXXXXX