--------------------------------------------------------------------------------------------------------------------------------------------
--------------------------------------------------------------------------------------------------------------------------------------------
--------------------------------------------------------------------------------------------------------------------------------------------
---------------Q-Q-Q-----------------------------------------------------------------------Q-Q-Q--------------------------------------------
--------------------------------------------------------------------------------------------------------------------------------------------
-------------------E----------------------------------------------------------------------E-------------------------------------------------
--------------------------SSS-------------------------SSS------o------------------------------------------------------o--------------------B
----------------------------------<>--------------------------------<>----------------------------------------------------------------------
----------------------------------[]--------------------------------[]----------------------------------------------------------------------
----------------------------------B---------------------------------------------------------------------------------------------------------
--------------------------------------------------------------------------------------------------------------------------------------------
--------------------------------------------------------------------------------------------------------------------------------------------
------------------------------X---------------------------X--------------------------X------------------------------------------------------
XXXXXXXXXXXXXXXXXXXXXXXXXXXXXXXXXXXXXXXXXXXXXXXXXXXXXXXXXXXXXXXXXXXXXXXXXXXXXXXXXXXXXXXXXXXXXXXXXXXXXXXXXXXXXXXXXXXXXXXXXXXXXXXXXXXXXXXXXXXX