--------------------------------------------------------------------------------------------------------------------------------------------
--------------------------------------------------------------------------------------------------------------------------------------------
--------------------------------------------------------------------------------------------------------------------------------------------
---------------------------------o----------------------------------------------------------------------------------------------------------
-----------------------------------S-S----??------------------------------------------------------------------------------------------------
-------------------------<>-------<>----------------------------------------------------------------<>--------------------------------------
-------------------------------<>-----------------------------------------------------------------<>----------------------------------------
---------------------E---------B-------------------------------------------------------------------B----------------------------------------
---------------------o-----------------------------------------------------------------------------------------------------o----------------
--------------------------------------------------------------------------------------------------------------------------------------------
------------------------------B----------------S-S-S------------------------------------------------------------------------------S---------
--------------------------------------------------------------------------------------------------------------------------------------------
--------------------------------------------------------------------------------------------------------------------------------------------
XXXXXXXXXXXXXXXXXXXXXXXXXXXXXXXXXXXXXXXXXXXXXXXXXXXXXXXXXXXXXXXXXXXXXXXXXXXXXXXXXXXXXXXXXXXXXXXXXXXXXXXXXXXXXXXXXXXXXXXXXXXXXXXXXXXXXXXXXXXX