--------------------------------------------------------------------------------------------------------------------------------------------
--------------------------------------------------------------------------------------------------------------------------------------------
S---------S----------E-----------------------------------------------------------------------------------o-------------------------------E--
--------------------------------------------------------------------------------------------------------------------------------------------
-------------------EXXXXXXXXXXXXXXXXXXXXXXXXXXXXXXXXXXXXXXXXXXXXXXXXXXXXXXXXXXXXXXoooooooooooooooooooooooooXXXXXXXXXXXXXXXXXXXXXXXXXXXXXXX--
----------------------S--------S--S--S--------------------------------------------------------------?---------------------------------------
---------E--------------------------------------------------------------------------------------------------------------E-------------------
--------------------------------------------------------------------------------------------------------------------------------------------
------------------------------o-------------------------E---------------------------------------------------o-------------------E-----------
--------------------------------------<>---------------------------------------------------------------------------------E------------------
---------S--S--------------------------<>-------------------------------------E-------------E-----------------------------------------------
--------------------------------------E[]-B-------------------------------------------------------------------------------------------------
-----------------------------------------B--------------------------------------------------------------------------------------------------
XXXXXXXXXXXXXXXXXXXXXXXXXXXXXXXXXXXXXXXXXXXXXXXXXXXXXXXXXXXXXXXXXXXXXXXXXXXXXXXXXXXXXXXXXXXXXXXXXXXXXXXXXXXXXXXXXXXXXXXXXXXXXXXXXXXXXXXX----