--------------------------------------------------------------------------------------------------------------------------------------------
--------------------------------------------------------------------------------------------------------------------------------------------
-------------------SS--SS-------------------------------------------------------------SS--SS------------------------------------------------
-------------------SS--SS-------------------------------------------------------------SS--SS------------------------------------------------
-------------------SS--SS-------------------------------------------------------------SS--SS------------------------------------------------
-------------------SS--SS-------------------------------------------------------------SS--SS------------------------------------------------
-------------------SS--SS-----SSS-----------------------------------------------------SS--SS------------------------------------------------
-------------------SS--SS-----SSS----SS--SSSS--SSSSSSSSS-----SSSSSSSSSS------SSSSS-----SS--SS-----------------------------------------------
-------------------SS--SS-----SSS------------b-----------B---------------------------------SS-----------------------------------------------
-------------------SS--SS----------------BBBBbBBB------BBooBB---E---------------------------SS----------------------------------------------
-------------------SS--SS-------------------?------------?-----------------------------SS--SS-----------------------------------------------
--------------------------<>-----------------------------<>---------------------------------------------------------------------------------
--------------------------[]-----------------------------[]---------------------------------------------------------------------------------
XXXXXXXXXXXXXXXXXXXXXXXXXXXXXXXXXXXXXXXXXXXXXXXXXXXXXXXXXXXXXXXXXXXXXXXXXXXXXXXXXXXXXXXXXXXXXXXXXXXXXXXXXXXXXXXXXXXXXXXXXXXXXXXXXXXXXXXX----