--------------------------------------------------------------------------------------------------------------------------------------------
--------------------------------------------------------------------------------------------------------------------------------------------
---------------------------o----------------------------------------------------------------------------------------------------------------
--------------------------o-----------------------------------------------------------------------------------------------------------------
-------------------------------------------------------------------------------E-----------------o------------------------------------------
----------------------------------------------------SSS-----------E-----------------o--o----------------------------------------------------
------------------------------<>------------------SSSSS--------------------o----------------------------------------------------------------
------------------------------[]-----------------------?SS-----o----------------------------------------------------------------------------
------------------------------------------------<>-----------SSS---------------------E------------------------------------------------------
-----------------------------------------------S[]---------------S?S------------------------------------------------------------------------
---------------------------------------<>--------SS--XXXXXXXXXXXXXXXXXXXXXXXXXXX------------------------------------------------------------
-------------------------<>-----------<>?-XXXXXXXXXXXXXXXXXXXXXXXXXXXXXXXXSSSSS-------------------------------------------------------------
-----------------------E-[]-----------[]-XXXXXXXXXXXXXXXXXXXXXXXXXXXXXXXXXXXXXXXXSS---------------------------------------------------------
XXXXXXXXXXXXXXXXXXXXXXXX<>XXXXXXXXXXXX[]XXXXXX--BB-XXXXXXXXXXXXXXXXXXXXXXXXEXXXXXXXXXXXXXXXXXXXXXXXXXXXXXXXXXXXXXXXXXXXXXXXXXXXXXXXXXXXXXXXX