--------------------------------------------------------------------------------------------------------------------------------------------
---------------o--------------------------------------o-------------------E--------------------o--------------------------------------------
--------------E----------o----------------o-------------------------------------------------------------------------------------------------
----------------------------------------B-------------------o--------o----------------------------------------------------------------------
-------------------------------<>--------------------o------------------o----------------------------------o--------------------------------
-------------------------------[]----------------E-----------------------E----------E-------------------------------------------------------
------------------------------?----???-----------------------------E----------------------------------------------------------------------E-
------------------SS----------<>-----------E------------------------EEE-------------------------E-------------------------------------------
-------------------------------B-------------------------------------------------------------------------------------------------------o----
--------------------------------------------------------------------------------------------------------------------------------------------
--------------------------------------------------------------------------------------------------------------------------------------------
--------------------------------------------------------------------------------------------------------------------------------------------
--------------------------------------------------------------------------------------------------------------------------------------------
XXXXXXXXXXXXXXXXXXXXXXXXXXXXXXXXXXXXXXXXXXXXXXXXXXXXXXXXXXXXXXXXXXXXXXXXXXXXXXXXXXXXXXXXXXXXXXXXXXXXXXXXXXXXXXXXXXXXXXXXXXXXXXXXXXXXXXXXXXXX