---------------------------------------------------o----------------------------------------------------------------------------------------
-------------------------------------------------oo-----------------------------------------------------------------------------------------
-----------------------------------------o------oooo----------------------------------------------------------------------------------------
------------------------------------------------oooo-------------------------------------------------------------------------------------E--
------------------------------<>---------<>----ooooo-----------------------------------------------------------------------------B--SSSSSSSS
------------------------------[]---------[]-----oooo-----------------------------------------------E----------------------------B--SSSSSSSSS
------------------------------[]---------[]------o---------------------------------------------B--------------------<>---------B------------
------------------------------[]---------[]-----------------------------------------------E---b--------------------<>-----------------------
---------------------------E----E--------------------E----------------------------------------b-------------------<>------------------------
---------------------------XXXXXXX--------XXXXX-----------------------------------------------b---E-E-E----------<>-------------------------
-------------------------------------------------------?--------------------------------------XXXXXXXXXXXXXXXXXXXXXXXXXXXXXXXXXXXXXXXXXXXXXX
XXXXXXXXXXXXXXXXXXXXXXXXXXXXXXXXXXXXXXXXXXXXXXXXXXXXXXXXXXXXXXXXXXXXX--XXXXXXXXXXXXXXX---XXXXXXXXXXXXXXXXXXXXXXXXXXXXXXXXXXXXXXXXXXXXXXXXXXX
--------------------------------------------------------------------------------------------------------------------------------------------
--------------------------------XXXXXXXXXXXXXXXXXXXXXXXXXXXXXXXXXXXXXXXXXXXXXXXXXXXXXXXXXXXXXXXXXXXXXXXXXXXXXXXXXXXXXXXXXXXXXXXX------------