--------------------------------------------------------------------------------------------------------------------------------------------
--------------------------------------------------------------------------------------------------------------------------------------------
--------------------------------------------------------------------------------------------------------------------------------------------
--------------------------------------------------------------------------------------------------------------------------------------------
--------E-----------------------------------------------------------------------------------------------------------------------------------
-----------SSSSSS-----------------------------SSSSSSS--------------------o------------Q----------------SSSSSSSSSSSS------------------Q------
---------------------------------------------------------<>--------------------------------------------------------------------------<>-----
---------------------------------------------------------[]-----------------------------------------------------------------------<>-[]-----
---------------------------------------------------------------------------------------------------------------------------------<>-<>------
---------------------------------------------------------------------------------------------------------------------------------[]-[]------
---------------------------------------------------------------------------------------------------------------------------------[]-[]------
---------------------------------------------------------------------------------------------------------------------------------[]-[]------
XXXXXXXXXXXXXXXXXXXXXXXXXXXXXXXXXXXXXXXXXXXXXXXXXXXXXXXXXXXXXXXXXXXXXXXXXXXXXXXXXXXXXXXXXXXXXXXXXXXXXXXXXXXXXXXXXXXXXXXXXXXXXXXXXXXXXXXXXXXX
--------------------------------------------------------------------------------------------------------------------------------------------