--------------------------------------------------------------------------------------------------------------------------------------------
--------------------------------------------------------------------------------------------------------------------------------------------
----?--?-------------?--------------------------------<>?---------------------??--------Q--------------------E------------------------------
--------------------------------------------------------------------------------------------------------------------------------------------
--------------------------------------------------------------------------------------------------------------------------------------------
-------S-----S------S-------------------------<>-------B---------------------------------------------E-------------S------------------------
-SSS---------------SSS------------------------SSS------SSS-----------------o??-----B------------------------------------SSS-----------------
-SSSSSSSSSSSSSSSSSSSSSS-------------------<>---------------B-------------------o--Q-------?-------------SSSSSS--------E---------------------
----------------------------S-------SSS<>---SSS------S------Q?------------------------------------------S----Q-------SS---------------------
---------------------------<>-------<>B-----------------------------------------------------------------<>--X-------B-----------------------
--------------------------------------<>---------------------------------B-----------------------------<>-----------------------------------
--------------------------------------------------------------------B-----------------------------------------------------------------------
---------------------XXXXXXXX-------------------------------------------------------------XXXXX---------------------------------------------
XXXXXXXXXXXXXXXXXXXXXXXXXXXXXXXXXXXXXXXXXXXXXXXXXXXXXXXXXXXXXXXXXXXXXXXXXXXXXXXXXXXXXXXXXXXXXXXXXXXXXXXXXXXXXXXXXXXXXXXXXXXXXXXXXXXXXXXXXXXX