--------------------------------------------------------------------------------------------------------------------------------------------
-----E----------------------------------------------------------E-------------------E-------------------------------------------------------
---------SSSS-------------------------------------------------------------------------------------------------------------------------------
---------------------------------------------------------------------?----------------------------------------------------------------------
----o--??Q---------------------------Q--------------------------B-------------------------------------?-------------------------------------
-----------------------S------------Q---?--------------------o---??---------------<>B-----------------------------<>--------------------S---
-----------------------SSS-----------------oSSSSS-------SSSSSS-------------------S--------S-------------------o----S------------------------
-----------------------SSSSS--------SSSSS----------S-------------------SSSSSS------SS---------SS----------------------SSS-------------------
--------------------------------------------------------------------------------------<>----------------------------------------------------
--------------------------------------------------------------------------------------------------------------------------------------------
--------------------------------------------------------------------------------------------------------------------------------------------
--------------------------------------------------------------------------------------------------------------------------------------------
-------------------XXXX--------------------------------------XXXX--------------------XXXX----------------XXXX-------------------------------
XXXXXXXXXXXXXXXXXXXXXXXXXXXXXXXXXXXXXXXXXXXXXXXXXXXXXXXXXXXXXXXXXXXXXXXXXXXXXXXXXXXXXX--XXXXXXXXXXXXXXXXXXXXXXXXXXXXXXXXXXXXXXXXXXXXXXXXXXXX