--------------------------------------------------------------------------------------------------------------------------------------------
--------------------------------------------------------------------------------------------------------------------------------------------
-------------o---------------------o--------------------------------------------------------------------------------------------------------
--------------------------------------------------------------------------------------------------------------------------------------------
----------------------------------------------<>----------B---------------------------------------------------------------------------------
----------------------------------------------[]----------b---------------------------------------------------------------------------------
----------------------------------------------[]---------EEB--------------------------------------------------------------------------------
----------------------------?---Q---?---------<>---------<>E--------------------------------------------------------------------------------
-----------------------------?---?------------[]---------[]---------------------------------------------------------------------------------
-------------------------------------------------------------------------------?------------------------------------------------------------
----------------------------------------SSSS------------------------------------------------------------------------------------------------
----------------------------------------SSSS------------------------------------------------------------------------------------------------
XXXXXXXXXXXXXXXXXXXXXXXXXXXXXXXXXXXXXXXXXXXXXXXXXXXXXXXXXXXXXXXXXXXXXXXXXXXXXXXXXXXXXXXXXXXXXXXXXXXXXXXXXXXXXXXXXXXXXXXXXXXXXXXXXXXXXXXXXXXX
XXXXXXXXXXXXXXXXXXXXXXXXXXXXXXXXXXXXXXXXXXXXXXXXXXXXXXXXXXXXXXXXXXXXXXXXXXXXXXXXXXXXXXXXXXXXXXXXXXXXXXXXXXXXXXXXXXXXXXXXXXXXXXXXXXXXXXXXXXXX