--------------------------------------------------------------------------------------------------------------------------------------------
--------------------------------------------------------------------------------------------------------------------------------------------
---------------------------------------------<>S---------------------------------<>B--------------------------------------------------------
-------------------------------------SSSS--------------------------------------------------SSSS---------------------------------------------
-----------------Q------------------------------SSSS---------------------------------------------SSSS---------------------------------------
-------------------------Q------------------------------------------------X------------------------Q----------------------------------------
--------------------SSSSS-----------------------------------------------------------------------------SSSS----------------------------------
--------------------SSSSS-----------------------------------------------------------------------------SSSS----------------------------------
--------------------------------------------------------------------------------------------------------------------------------------------
-------------------------------------------<>-----------------------------------------------------------------------------<>----------------
---------------------------------XXXXXXX---[]-----------<>---------XXXXXXX-------Q--------------XXX-----------------------------------------
XXXXXXXXXXXXXXXXXXXXXXXXXXXXXXXXXX<>XXXXXXXXXXXXXXXXXXXXXXXXXXXXXXXXXXXXXXX-------------------------XXXXXXXXXXXXXXXXXXXXXXXXXXXXXXXXXXXXXXXX
XXXXXXXXXXXXXXXXXXXXXXXXXXXXXXXXXX[]XXXXXXXXXXXXXXXXXXXXXXXXXXXXXXXXXXXXXXX-------------------------XXXXXXXXXXXXXXXXXXXXXXXXXXXXXXXXXXXXXXXX
--------------------------------------------------------------------------------------------------------------------------------------------