--------------------------------------------------------------------------------------------------------------------------------------------
--------------------------------------------------------------------------------------------------------------------------------------------
--------------------------------------------------------------------------------------------------------------------------------------------
-----------o-------------------o---------------------------SS-------------------------------------------------------------------------------
------------------------------------------------------------E-------------------------------------------------------------------------------
----------------o-------------------o-------------------E---S--------------------------------------------------------------------------o----
-----------------------------E-------------------------------S-----------E------E-------E-----------------------------------------------E---
------------------------------------------?S?------------------------------------S----------------------Q-------------------------------S---
-------------<><><>------------------------S----------------Q?B<>----------------------------------------B------?------------------------S--
-------------[][][]-----------------------------------------------------------SSSSSSSS-------------------<>---------------------------------
----------E-<><><>--<>--------------------------E---------------------------E-<><><>--------------------<>----------------------------------
----------XX[][][]-XX<>----------------------E-XX<>---------------------------[][][]--------------------[]-------------------------------E--
XXXXXXXXXX--[]--------------S--S------X---XXX-----<>-----------------E--------[][][]---------------------X--------------------------------XX
XXXXXXXXXXXXX-------------------------------XXXX-------------------------------<>----------------------XXX---------------------------XXXXXXX