---------------------------E----------------------------------------------------------------------------------------------------------------
---------------o----------------------------------------------------------------------------------------------------------------------------
------------SSSSSSSS-----------------------------------------------------------B------------------------------------------------------------
--------------------------------------------------------------------------------------------------------------------------------------------
--------------Q---Q---Q------------------------------------Q-----------------------------------------------------------------------?--------
--------------------SSSS-----E-----------Q---------------------------Q?------------------------<>Q------------------------------------------
--------S--------SS---SS----------------------------------------------------??-------------------------------<>-------------------S---------
--------SSSS---SSS-------------------------------------------------------------------SSSS---------------------------------------------------
---------SSS??SSSS--------------------??-------------------------------------------B--------------------------------------------------------
--------------------------------------------------------------------------------------------------------------------------------------------
--------------------------------------------------------------------------------------------------------------------------------------------
--------------------------------------------------------------------------------------------------------------------------------------------
--------------------XXXXX---------------------------------------XXXXX---------------------------------------XXXXX---------------------------
XXXXXXXXXXXXXXXXXXXXXXXXXXXXXXXXXXXXXXXXXXXXXXXXXXXXXXXXXXXXXXXXXXXXXXXXXXXXXXXXXXXXXXXXXXXXXXXXXXXXXXXXXXXXXXXXXXXXXXXXXXXXXXXXXXXXXXXXXXXX