--------------------------------------------------------------------------------------------------------------------------------------------
--------------------------------------------------------------------------------------------------------------------------------------------
--------------------------------------------------------------------------------------------------------------------------------------------
------------------??-----------------??-----------------------------------------------------------------------------------------------------
------------------??-----------------??----------------------------oo-----------------------------------------------------------------------
--------------------------------------------------------------------------------------------------------------------------------------------
-------------------------------------------S------------S-----<>---------S-------S----------------------------------------------------------
--------------------------------------------------------------------------------------------------------------------------------------------
------------E-----------------------------------------------------------------------------E-------------------------------------------------
--------------------------------------------------------------------------------------------------------------------------------------------
-----------------------------oo-------B-----------------------------------------------------------------------------------------------------
----------------------------------B---------------------------------------------------------------------------------------------------------
--------------------------X---------------X-----X------------X------------X-------X-------------X------------------------------X------------
XXXXXXXXXXXXXXXXXXXXXXXXXXXXXXXXXXXXXXXXXXXXXXXXXXXXXXXXXXXXXXXXXXXXXXXXXXXXXXXXXXXXXXXXXXXXXXXXXXXXXXXXXXXXXXXXXXXXXXXXXXXXXXXXXXXXXXXXXXXX