--------------------------------------------------------------------------------------------------------------------------------------------
--------------------------------------------------------------------------------------------------------------------------------------------
-------------------?-----?----------------------------------------------------------?------?------------------------------------------------
----------------------------------SSSSS-----------------------------------------------------------------------------------------------------
-------------------------Q------------------------------------------------X------------------------Q----------------------------------------
--------------------SSSSS-------------------------?-------------------------SSSSS------------------------------------?----------------------
--------------------------------------------------------------------------------------------------------------------------------------------
--------------------------------------------------------------------------------------------------------------------------------------------
--------------------------------------------------------------------------------------------------------------------------------------------
-------------------------------------------<>-----------------------------------------------------------------------------<>----------------
---------------------------------XXXXXXX---[]-----------<>---------XXXXXXX-------Q--------------XXX-----------------------------------------
XXXXXXXXXXXXXXXXXXXXXXXXXXXXXXXXXX<>XXXXXXXXXXXXXXXXXXXXXXXXXXXXXXXXXXXXXXX-------------------------XXXXXXXXXXXXXXXXXXXXXXXXXXXXXXXXXXXXXXXX
XXXXXXXXXXXXXXXXXXXXXXXXXXXXXXXXXX[]XXXXXXXXXXXXXXXXXXXXXXXXXXXXXXXXXXXXXXX-------------------------XXXXXXXXXXXXXXXXXXXXXXXXXXXXXXXXXXXXXXXX
--------------------------------------------------------------------------------------------------------------------------------------------