--------------------------------------------------------------------------------------------------------------------------------------------
--------------------------------------------------------------------------------------------------------------------------------------------
-------------------?-----?-----------------------------<>S--------------E------------?------?-------o---------------------------------------
----------------------------------SSSSS-------------<>-------------------------------------B--------------------------------o---------------
-------------------------Q------------------------------------------------X------------------------Q----------------------------------------
--------------------SSSSS-------------------------?-------------------------SSSSS------------------------------------?----------------------
--------------------------------------------------------------------------------------------------------------------------------------------
--------------------------------------------------------------------------------------------------------------------------------------------
--------------------------------------------------------------------------------------------------------------------------------------------
-------------------------------------------<>E----------------------------------------------------------------------------<>----------------
---------------------------------XXXXXXX---[]-----------<>-------E--XXXXXXX-------Q--------------XXX----------------------------------------
XXXXXXXXXXXXXXXXXXXXXXXXXXXXXXXXXX<>XXXXXXX[]XXXXXXXXXXXXXXXXXX<>XXXXXXEEE------------------------XXXXXXXXXXXXXXXXXXXXXXXXXXXXXXXXXXXXXXXXXX
XXXXXXXXXXXXXXXXXXXXXXXXXXXXXXXXXX[]XXXXXXX[]XXXXXXXXXXXXXXXXXX[]XXXXXXEEE------------------------XXXXXXXXXXXXXXXXXXXXXXXXXXXXXXXXXXXXXXXXXX
--------------------------------------------------------------------------------------------------------------------------------------------