--------------------------------------------------------------------------------------------------------------------------------------------
--------------------------------------------------------------------------------------------------------------------------------------------
--------------------------------------------------------------------------------------------------------------------------------------------
--------------------------------------------------------------------------------------------------------------------------------------------
--------------------------------------------------------------------------------------------------------------------------------------------
-------------------------------------B---------------------------------------------------B--------------------------------------------------
-------------------------------------<>--------------------------------------------------[]-------------------------------------------------
--------------------------------------<>-------------------------------------------------<>-------------------------------------------------
---------?--------------------?--------------------?--------------------?-------------------------------------------------------------------
---------?------------------E-?------------------E-?-----o------------E-?-----------E----<>-------------------------------------------------
---------?--------------------?--------------------?--------------------?----------------[]-------------------------------------------------
--------------------------------------<>--------------------------------------------------------------------<>------------------------------
--------------------------------------[]--------------------------------------------------------------------[]------------------------------
XXXXXXXXXXXXXXXXXXXXXXXXXXXXXXXXXXXXXXXXXXXXXXXXXXXXXXXXXXXXXXXXXXXXXXXXXXXXXXXXXXXXXXXXXXXXXXXXXXXXXXXXXXXXXXXXXXXXXXXXXXXXXXXXXXXXXXXXXXXX