--------------------------------------------------------------------------------------------------------------------------------------------
--------------------------------------------------------------------------------------------------------------------------------------------
--------------------------------------------------------------------------------------------------------------------------------------------
-----------------------------------------------B--------------------------------------------------------------------------------------------
-----------------------------------------------b------<>------------------------------------------------------------------------------------
-----------------------------------------------b------[]------------------------------------------------------------------------------------
-----------------------------------B------So--b?-<>--------o------------------------------------------------------------------------------o-
------------------------------------------So--b?-[]--o--------------------------------------------------------------------------------------
------------------------------------------S---b?-[]--o-o-------------------------------------------------------------o----------------------
------------------------------SQS-S----S--S---b?-[]-----------------------------------------------------------------------------------------
------------------------------SSS------S--S---b?-[]--------------------------------o--------------------------------------------------------
-----------------------------------------------b<>--------------------------------o---------------------------------------------------------
-----------------------------------------------b[]--E----------------------------oo---------------------------------------------------------
XXXXXXXXXXXXXXXXXXXXXXXXXXXXXXXXXXXXXXXXXXXXXXXXXXXXXXXXXXXXXXXXXXXXXXXXXXXXXXXXXXXXXXXXXXXXXXXXXXXXXXXXXXXXXXXXXXXXXXXXXXXXXXXXXXXXXXXXXXX-