--------------------------------------------------------------------------------------------------------------------------------------------
--------------------------------------------------------------------------------------------------------------------------------------------
--------------------------------------------------------------------------------------------------------------------------------------------
--------------------------o-----------------------------------------------------------------------------------------------------------------
----------E--------------------E-------------SSSSSSSSS---?-----------------------------?---------------------SSSSSSSSSSS------S-------------
SSSSSS-----XXXX-------------XXXX--oooooooo---SSSSSSSSSS--------------------------------SSSSSSSS---SSSSSS-----SSSSSSSSSSSS------Q------------
XXXXXXXXXXXXXXXXX--------XXXXXX---SSSSSSSS---SSSSSSSSSSSS-------------------SSSS-------SSSSSSSS---SSSSSSS-B---SSSSS----SSSSS---E------------
XXXXXXXXXXXXXX-----------SSSSSS--XXX--SSS-----XXXXSSSSSSSS----------------<>SSSSSSB----SSSSSSSS---SSSSSSo<>---SSSSSSBX<>SSSS---Q------------
---------SSSSSS---------<><>SSSSSSSSo<><>Q---SSSSSSSSSSSSS----------<>-----<>SSSS<>----SSSSSSSS---SSSSSS<>----SSSSSS<>-<><><>---Q-----------
XXXXXXXXXXXXXXXXXXXXXXXXXXXXX<>--XX-<>---XXXXSSSSSSSSSSSS--------E-<>------[]SSSS[]----SSSSSSSS---SSSSSS[]----SSSSSS[]-[]--[]---Q-----------
XXXXXXXXXXXXXXXXXXXXXXXXXXXXXXXXXX?<>XXXXXXXXXXXXXXXXXXXXXXXXXXXXXXXXXXXXX---------XXXXXXXXXXXXXXXXXXXXXXXXXXXX-<><>---[]<>[]---XXXXXXXXXXXX
--------------------------------------------------------------------------------------------------------------------------------------------
--------------------------------------------------------------------------------------------------------------------------------------------
--------------------------------------------------------------------------------------------------------------------------------------------