--------------------------------------------------------------------------------------------------------------------------------------------
--------------------------------------<>----------------------------------------------------------------------------------------------------
--------------------------------------[]<>--------------------------------------------------------------------------------------------------
--------------------------------------[][]--------------------------------------------------------------------------------------------------
-------------------S-----S---SS--------<><>----------S---S------------------------------------------SSSSSSSS--------------------------------
----------------------------------------------Q---Q---Q---------------------------------------------Q---QQQ---------------------------------
-----------------------------------o--------------------------------------------------------------------------------------------------------
--------------------------------------------------------------------------------------------------------------------------------------------
--------------------------------------------------------------------------------------------------------------------------------------------
--------------------------------------------------------------------------------------------------------------------------------------------
--------------------------------------------------------------------------------------------------------------------------------------------
-------------------------------------B------------------------------------------------------------------------------------------------------
-----------------------------B-----------------o--------------------------------------------------------------------------------------------
XXXXXXXXXXXXXXXXXXXXXXXXXXXXXXXXXXXXXXXX---E----E-------E------------XXXXXX--XXXXXXXXXXXXXXXXXXXXXXXXXXXXXXXXXXXXXXXXXXXXXXXXXXXXXX---------