--------------------------------------------------------------------------------------------------------------------------------------------
--------------------------------------------------------------------------------------------------------------------------------------------
--------------------------------------------------------------------------------------------------------------------------------------------
--------------------------S-----------------------------------------------------------------------------------------------------------------
--------------------------SSS------------------------SS?S?SSS-------------------------------------------------------------------------------
--------------------------SSS-----------------------SSSSSSSSS---SS--?-----------------------------------------------------------------------
-------------------------SSSSS----------------------SSSSSSSS-------SSS----------------------------------------------------------------------
------------------------SSSSSSS---------------------SSSSSSSS?S------------------------------------------------------------------------------
------------------------SSSSSSSSS------------------------------------------E----------------------------------------------------------------
--------------------------SSSSSSSSS---------------------------------------------------------------------------------------<>----------------
--------------------------SSSSSSSSS----B------<>--------------------------------------------------------------<>------------<>--------------
--------------------------SSSSSSSSS----<>-----[]--------------------------------------------------------------[]------------[]--------------
---E----E------------------SSSSSSSSS----<>-----<>-----E-------------------------------------------------------[]------------[]--------------
XXXXXXXXXXXXXXXXXXXXXXXXXXXXXXXXXXXXXXXXXXXXXXXXXXXXXXXXXXXXX---XXXXXXXXXXXXXXXXXXXXXXXXXXXXXXXXXXXXXXXXXXXXXXXXXXXXXXXXXXXXXXXXXXXXXXXXXX--