--------------------------------------------------------------------------------------------------------------------------------------------
--------------------------------------------------------------------------------------------------------------------------------------------
--------------------------------------------------------------------------------------------------------------------------------------------
-------------------------EEE-----------------------------------------------------------o--------QQQ-----------------------------------------
-----------------------XXXX-----------------------------------------------------------------------------------------------------------------
-----------------------------?--------------------------------------------------------------------------------------------------------------
-----------------------------------------------------------------------E--------------------------------------------------------------------
--------------------------------------------------------------------------<>---------------------<>--------------------QQQQQ----------------
--------------------------------------------------------------------------[]---------------------[]-----------------------------------------
-------------------SSSSS--------------------------------------------------------------------------------------------------------------------
----------------------------SSSSBB----------------------------------------------------------------------------------------------------------
-------------------------------------------XXXXXXXXXXX-------------SSSSSS-----------SSSSSS--------E-----------------------------------------
-----------------------XXXXXXXXXXXXXXXXXXXXXXXXXXXXXXXXXXXXX---XXXXXXXXXXXXXXXXXX----XXXXXXXXXXXXXXXXXXXXXXXXXXXXXXXXXX---------------------
XXXXXXXXXXXXXXXXXXXXXXXXXXXXXXXXXXXXXXXXXXXXXXXXXXXXXXXXXXXXXXXXXXXXXXXXXXXXXXXXXXXXXXXXXXXXXXXXXXXXXXXXXXXXXXXXXXXXXXXXXXXXXXXXXXXXXXXXXXXX