--------------------------------------------------------------------------------------------------------------------------------------------
--------------------------------------------------------------------------------------------------------------------------------------------
---------------------------------------------------o----------------------------------------------------------------------------------------
--------------------------------------------------------------------------------------------------------------------------------------------
-------------------------------o------------------------------------------------------------------------------------------------------------
-----------------------------------------BSBS?--------------------------------------------------------------------E-------------------------
------------------------------------------SSSSS---------------Q?Q---------------------------------------------------------------------------
--------------------------o-----------------------------------------------------------------------------------------------------------------
-----------------------------<>-----------------------------------------------E-------------------------------------------------------------
--------------------Q?Q?----<>---------------------------------Q?Q?-------------------------------------------------------------------------
------------------------SSSSS-----------------?Q?Q?------------SSSSS--------------------------------------------Q?Q?------------------------
----------------------------<>--------------------------------------------------------------------------------------------------------------
----------------------------[]---------------------------------------------------------------------------------------------<>---------------
XXXXXXXXXXXXXXXXXXXXXXXXXXXXXXXXXXXXXXXXXXXXXXXXXXXXXXXXXXXXXXXXXXXXXXXXXXXXXXXXXXXXXXXXXXXXXXXXXXXXXXXXXXXXXXXXXXXXXXXXXXXXXXXXXXXXXXXXXXX-