--------------------------------------------------------------------------------------------------------------------------------------------
--------------------------------------------------------------------------------------------------------------------------------------------
----SSSSB------------------------------------------------SSSS---???-------------------------------------------------------------------------
----SSSS--------------------------------------------------SSSS------------------------------------------------------------------------------
----SSSS-------------------------Q------------------------SSSS-----------------o----------------<>-----B---------------------E--oo---------X
---E-------------------------------------------------------------------------------------------------------------------------------------E--
----EE-------------------ooo----------------------------------------------------------------------------------------------------------------
-------------------------------------<>-------------------<>--------------------------------------------------------------------------<>----
-------------------------------------[]-------------------[]--------------------------------------------------------------------------[]----
---------------------b---------------b--------------------B--------------------------------------------------------------------------<>-----
---------------------b---------------b-----------------------------------------------------------------------------------------------[]-----
---------------------b----------------------------------------------------------------------------------------------------------------------
XXXXXXXXXXXXXXXXXXXXXXXXXXXXXXXXXXXXXXXXXXXXXXXXXXXXXXXXXXXXXXXXXXXXXXXXXXXXXXXXXXXXXXXXXXXXXXXXXXXXXXXXXXXXXXXXXXXXXXXXXXXXXXXXXXXXXXXX----
XXXXXXXXXXXXXXXXXXXXXXXXXXXXXXXXXXXXXXXXXXXXXXXXXXXXXXXXXXXXXXXXXXXXXXXXXXXXXXXXXXXXXXXXXXXXXXXXXXXXXXXXXXXXXXXXXXXXXXXXXXXXXXXXXXXXXXXX----