--------------------------------------------------------------------------------------------------------------------------------------------
--------------------------------------------------------------------------------------------------------------------------------------------
--------------------------------------------------------------------------------------------------------------------------------------------
--------------------------------------------------------------------------------------------------------------------------------------------
------------------S-----S-------------------------S-----------------------------------------------------------------------------------------
------------E----------------------------------------------------------------------------------------------------------------------o--------
------------S-----------------------------E-----------------------S-----------------<>------------------------------------------------------
-------------------------------o---------S-----o------------------S------------------<>-----------------------------------------------------
------------<>---------------------------S------------------------S------------------[]---------------------------o-------------------------
------------[]-------------E-------------S------------------------S------------------[]-----------------------------------------------------
------------[]-------------o-------------S-------------<>---------S------------------[]-----------------------------------------------------
------------[]---<><><>---X----------------------------------------------------------[]-------------------------<>--------------------------
------------[]---[][][]---XX<>B-------------------------<>----------------E--E---------<>-----------------------B---------------------------
XXXXXXXXXXXXXXXXXXXXXXXXXXXXXXXXXXXXXXXXXXXXXXXXXXXXXXXXXXXXXXXXXXXXXXXXXXXXXXXXXXXXXXXXXXXXXXXXXXXXXXXXXXXXXXXXXXXXXXXXXXXXXXXXXXXXXXXXXXXX