--------------------------------------------------------------------------------------------------------------------------------------------
--------------------------------------------------------------------------------------------------------------------------------------------
---------------------------------SS--------SSS----------------------------------------------------------------------------------------------
-------------------------------SS-B-SS-----SSS-------------------------------------------------------------------SS-------------------------
-------------------------------BB------SSS----SS-------------------------------SS------------SSS--------------------------------------------
-------------------------------------?--E----------------------------------------------------------------------------??---------------------
-----------------------------<>---------------------------------o-----------------------------------------------<>--------------------------
-----------------------------[]---------------------------------------------------------------------------------[]--------------------------
-----------------------------[]-------------------------------------------------------------------------E--------<>-------------------------
--------------------------------------------------------------------------------------------------------------------------------------------
--------------------------------------------------------------------------------------------------------------------------------------------
--------------------------------------------------------------------------------------------------------------------------------------------
--------------------------------------------------------------------------------------------------------------------------------------------
XXXXXXXXXXXXXXXXXXXXXXXXXXXXXXXXXXXXXXXXXXXXXXXXXXXXXXXXXXXXXXXXXXXXXXXXXXXXXXXXXXXXXXXXXXXXXXXXXXXXXXXXXXXXXXXXXXXXXXXXXXXXXXXXXXXXXXXXXXXX