--------------------------------------------------------------------------------------------------------------------------------------------
--------------------------------------------------------------------------------------------------------------------------------------------
------------------------------------------------------------------------------------------------<>------------------------------------------
--------------------o----------------------------------------------------------------------------<>-----------------------------------------
--------------------------------------------------------------------------------------------------<>----------------------------------------
-------------------S-----S----SSS---SSS-----------------------------S---S-------SSS-----------------<>--------------------------------------
--------------------------------------------------------------------------Q---Q---Q---------------------------------------------------------
-------------------------------------------------------------------------o----------------------o-------------------------------------------
--------------------------------------------------------------------------------------------------------------------------------------------
-------------------------------------o------------------------------------------------------------------------------------------------------
--------------------------------------------------------------------------------------------------------------------------------------------
-------------------------------------------------------------B-----------B------------------------------------------------------------------
-------------------------------------------------------------b-----------b------------------------------------------------------------------
XXXXXXXXXXXXXXXXXXXXXXXXXXXXXXXXXXXXXXXXXXXXXXXXXXXXXXXXXX---E--E-----E--E-------------------------XXXXXXXXXXXXXXXXXXXXXXXXXXXXXXXXXXXXXXX--