--------------------------------------------------------------------------------------------------------------------------------------------
--------------------------------------------------------------------------------------------------------------------------------------------
--------------------------------------------------------------------------------------------------------------------------------------------
-------------------------------------------------------o------------------------------------------------------------------------------------
--------------------------------------------------------------------------------------------------------------------------------------------
------------------------------------o-------------------------------------------------------------------------------------------------------
--------------------------------------------------------------------------------------------------------------------------------------------
-------------------o------------------------------------------------------------------------------------------------------------------------
-----------S----------------------------------------------------???-------------------------------------------------------------------------
----SSS---S-----------------------------SSS---------------???---<>-----E---------<><>------------------------B------------------------------
-------S---------E----------------------------------------------???-------------------------------------------------------------------------
------------E--------------------------------XXX-------------------------------------------------------------------------B------------------
---------------------------------------------XXXX-----------------------------------------------------------------B-------------------------
XXXXXXXXXXXXXXXXXXXXXXXXXXXXXXXXXXXXXXXXXXXXXXXXXXXXXXXXXXXXXXXXXXXXXXXXXXXXXXXXXXXXXXXXXXXXXXXXXXXXXXXXXXXXXXXXXXXXXXXXXXXXXXXXXXXXXXXXXXXX