--------------------------------------------------------------------------------------------------------------------------------------------
--------------------------------------------------------------------------------------------------------------------------------------------
--------------------------------------------------------------------------------------------------------------------------------------------
----------------<>--------------------------------------------------------------------------------------------------------------------------
----------------[]--------------------------------------------------------------------------------------------------------------------------
---SSSSS------<>------------------------<>-----BB-------------------------------------------------------------------------------------------
-----------???[]------------------------[]-----bb-------------------------------------------------------------------------------------------
-----------SSSS-------------------------B--------------<>--------------------------------------------B--------------------------------------
-----------------------------B---------Bb--------------[]--------------------------------------------b--------------------------------------
-----------------------------b-------------------------[]------------------------<>------------B----b---------------------------------------
----------------B-----------<>-------------------------[]------------------------[]------------b----b---------------------------------------
----------------b-----------[]-------------------------[]--------------------------------------<>----B--------------------------------------
---------------------------------XXXXXXXXXXXXXXXXXXXXXXXXXXXXXXXXXXXXXXXXXXXXXXXXXXXXXXXXXXXXXXXXXXXXXXXXXXXXXXXXXXXXXXXXXXXXXXXXXXXXX------
XXXXXXXXXXXXXXXXXXXXXXXXXXXXXXXXXXXXXXXXXXXXXXXXXXXXXXXXXXXXXXXXXXXXXXXXXXXXXXXXXXXXXXXXXXXXXXXXXXXXXXXXXXXXXXXXXXXXXXXXXXXXXXXXXXXXXXXXXX--