--------------------------------------------------------------------------------------------------------------------------------------------
--------------------------------------------------------------------------------------------------------------------------------------------
--------------------------------------------------------------------------------------------------------------------------------------------
--------------------------------------------------------------------------------------------------------------------------------------------
---------------------------------------o-o------------------------o-----------------------o----------------------------o-o-o----------------
----------oo---------------o--------------------oo--------o--------o-----------------------o-------------o----o-o-----o---o-o---------------
------------------oooo-------o-o-ooo--o-o-----o---o--------ooo------oo---------oo---------------------------o--o-oo--o----------------------
--------o----o--------o-----o-o-----o-----o--------o---o-----------S?-----o------o---oo---?S??--o--------X-o-o-----oo---?S-S----------------
------S?X?X---------------?X-?XX?S-------------X?X----o-------o-------oo-o---o----o------o----o---ooo---------?-S?--------------------------
--------------o--------oo---------??---------S----?X-?--o--------o---------o-----------oo--------o---o----SS?X----?-------------------------
------------------------------------------------------SS--------------X-S?S----------????X----S?--------------------------------------------
------------------XXXX----------------XXXX----------------XXXX----XXXX--------------------XXXX--------XXXX------------XXXXXXXX--------------
XXXXXXXXXXXXXX----XXXX----XXXXXXXX----XXXX----XXXX--------XXXX----XXXX--------XXXX--------XXXX--------XXXX----XXXX----XXXXXXXX--------------
XXXXXXXXXXXXXX----XXXX----XXXXXXXXXXXXXXXXXXXXXXXXXXXX----XXXX----XXXX--------XXXX--------XXXX--------XXXXXXXXXXXXXXXXXXXXXXXXXXXXXXXXXXXXXX
