--------------------------------------------------------------------------------------------------------------------------------------------
--------------------------------------------------------------------------------------------------------------------------------------------
--------------------------------------------------------------------------------------------------------------------------------------------
--------------------------------------------------------------------------------------------------------------------------------------------
----------ooo--------o------------------------ooo----------o----------------------------------------------------oo--------------------------
--------------------o--o-o------------------------------o---oo--o-----------------------o-o--o-------------------------o-o------------------
----------------o--o----------o-----------oooo---o---oo---o----------------o-oo----------o-oo----o----o-oo-o-oo-----------------------------
----------?XS---------o---o-----o----o-o-o-----X?Xoo----------o--o----oo--------------??-X-----o-----o------o-?X??---o--S-------------------
--------oo-------------???----------o---o-------------???--------?oo-o---------ooo--------S--S--o--oo------?-S----o--------ooo--------------
------?-?-------------------oo-XS-----o------------SS?------------XS-X--oo-------?o---------------o-----------------------o-----------------
--------------------------?-S------------------------------------------XS?--------?XSS------------------------------------?X-X--------------
----------XXXX----XXXX--------------------XXXXXXXX--------XXXX------------XXXX--------XXXX--------------------XXXX----XXXX----------XXXXXXXX
----------XXXX----XXXXXXXX----------------XXXXXXXX----XXXXXXXXXXXX--------XXXX--------XXXXXXXX------------XXXXXXXX----XXXX----------XXXXXXXX
XXXXXXXXXXXXXXXXXXXXXXXXXX----XXXX--------XXXXXXXXXXXXXXXXXXXXXXXXXXXX----XXXXXXXX----XXXXXXXXXXXX----XXXXXXXXXXXX----XXXX----------XXXXXXXX
