--------------------------------------------------------------------------------------------------------------------------------------------
--------------------------------------------------------------------------------------------------------------------------------------------
--------------------------------------------------------------------------------------------------------------------------------------------
--------------------------------------------------------------------------------------------------------------------------------------------
-------o----------------------------------oo-oo-o--------------------------------------------------o-----------o----------------------------
------o-------------------o-o---------------o--o-o------------------------------------o--o--------------------o--o--------------------------
--------ooo---------oo-------o-----------o--------ooo--------o--------oo---------------o----------o-oo---o---o---------oo-------------------
------S??SXXX?-----o----o-?X?S-----o-o------?SSX-?---o--ooooo--oo-oooo----o--oo------o----o-o--oo-----ooo------?----o-o---o-o---------------
------------------------------o---o---ooo----------S-So----------o--------------o-o---??SS----?---------S?-oo----------------o--------------
----------------------oo-o----SS-----------------------?-------------------------o-o----------------------SSS?-------o--?S?-?X--------------
-------------------------?----------------------------------------?SSS-------------X-------XS?--------------------??------------------------
XXXXXXXXXXXXXX------------XXXX------------XXXXXXXX------------------------------------------------XXXX--------XXXX--------------------------
XXXXXXXXXXXXXXXXXX--------XXXX------------XXXXXXXXXXXX----XXXX--------XXXX------------XXXX----XXXXXXXXXXXX----XXXX--------------------------
XXXXXXXXXXXXXXXXXXXXXX----XXXXXXXXXXXXXXXXXXXXXXXXXXXXXXXXXXXX--------XXXXXXXX--------XXXX----XXXXXXXXXXXXXXXXXXXX----XXXXXXXXXXXX--XXXXXXXX
