--------------------------------------------------------------------------------------------------------------------------------------------
--------------------------------------------------------------------------------------------------------------------------------------------
--------------------------------------------------------------------------------------------------------------------------------------------
--------------------------------------------------------------------------------------------------------------------------------------------
---------o-------o----o-o--o------------oo-----------------------------------------oo-------------o-----------------------------------------
--------o-o-o-oo--oo--------oo--------o----------------o------o------------------------------------oo-----------o---o-----o-o---------------
-----------o--------o------------------o------o-oo----------o--oo------o--o--o----o--o---o-----o------------o--o------o-o----o--------------
-------?-S-----?--------------oo-----o-----ooo-o---o--o----o-o---X--o-o--------------?------o-----------------o---o--------o----------------
-----------X?-------------------o--oo---------?X----S??---o----------o--o------o-o---------------o--------?XS-X?-?X----o-oXX-?--------------
--------------------------------?Xo--------------------------------o--SS?-----o-o-----?--S---o?----------?--------------??------------------
-----------------------------------S------??-?--------------------SS-S--------------------XX?-----------------------------------------------
XXXXXXXXXX----XXXXXXXXXXXXXXXX--------XXXX--------------------XXXX--------XXXX----XXXX------------XXXX----------------------------XXXXXXXXXX
XXXXXXXXXXXXXXXXXXXXXXXXXXXXXX--------XXXX----XXXXXXXXXXXX----XXXX--------XXXX----XXXX------------XXXX----XXXXXXXXXXXX----XXXX----XXXXXXXXXX
XXXXXXXXXXXXXXXXXXXXXXXXXXXXXXXXXX----XXXX----XXXXXXXXXXXXXXXXXXXX----XXXXXXXX----XXXXXXXX----XXXXXXXXXXXXXXXXXXXXXXXXXXXXXXXXXXXXXXXXXXXXXX
