--------------------------------------------------------------------------------------------------------------------------------------------
--------------------------------------------------------------------------------------------------------------------------------------------
--------------------------------------------------------------------------------------------------------------------------------------------
--------------------------------------------------------------------------------------------------------------------------------------------
----------------------------------------------------o---------------------o--o--o-----------o----------------------------o------------------
------------------------------oo--------------oooo-o--------o------oo------o---o-o------------------------------o------oo----o--------------
----------------------o----------o----o---ooo--------o-o-------------o--o-----------------oo----------o-oo----oo----o-o---------------------
----------o--o----o-o--o-o-------------ooo?S-SX-XXS------o-o----------------------o-o-o--o?--?--o-o--o---------------o--?-oo----------------
---------o-----------o---------X?Xo--o------------------------o----XS?oo----------?-SS-o------o--o-----------oX-?---------?XS?--------------
------XS---o----S--o----?-oo-o-----S---------------------------o------XS-S-------------------------oo----?--o-------------------------------
----------?XX-------------X??S--------------------------------------------------------SX??----X-----------S??S------------------------------
------------------------------------------XXXXXXXXXXXX--------------------XXXXXXXX--------XXXX------------------------XXXX--------XXXXXXXXXX
------------------------------XXXX--------XXXXXXXXXXXXXXXXXXXX----XXXX----XXXXXXXXXXXX----XXXX----------------XXXXXXXXXXXXXXXX----XXXXXXXXXX
XXXXXXXXXX----XXXX----XXXX----XXXXXXXXXXXXXXXXXXXXXXXXXXXXXXXX----XXXXXXXXXXXXXXXXXXXX----XXXX--------XXXX----XXXXXXXXXXXXXXXXXXXXXXXXXXXXXX
