--------------------------------------------------------------------------------------------------------------------------------------------
--------------------------------------------------------------------------------------------------------------------------------------------
--------------------------------------------------------------------------------------------------------------------------------------------
--------------------------------------------------------------------------------------------------------------------------------------------
-------------------------------------------------------o--o--o-----------o-oo-o-o----------o----------------------------o-------------------
---------o-------o---------o-o---------------------o--o--o-o---------------------o-------oo--------o-----o----------------------------------
-------o--------o-o-----------o--------o--o-o---------------o-o-------oo-------o---o---o----oo-o-oo-ooo---o-o------o--oo--------------------
--------o-----------o-----------o-------o----o---oo-------------------??XS-?-X------oo----S?XXo--------------o---oo-o---XS------------------
-------S?X--------------??XX?X-o-o-o--o--o---------------------S-----o------------------?-------o-------------o-----------o-o---------------
----------oo------------------?-XS-----------?--o-----------------ooo-------------------------S------------?-SXX--?--------o----------------
----------X-----------------------?-----------?--?-----------------?X?-------------------------------------------------------X--------------
------------------------------------------------------XXXXXXXX--------XXXXXXXXXXXX--------XXXX----XXXX----------------XXXX--------XXXXXXXXXX
XXXXXXXXXX----XXXX----XXXXXXXX--------------------XXXXXXXXXXXXXXXX----XXXXXXXXXXXXXXXXXXXXXXXX----XXXXXXXX------------XXXX----XXXXXXXXXXXXXX
XXXXXXXXXX----XXXXXXXXXXXXXXXXXXXX----XXXXXXXX----XXXXXXXXXXXXXXXX----XXXXXXXXXXXXXXXXXXXXXXXXXXXXXXXXXXXXXXXXXXXXXXXXXXXX----XXXXXXXXXXXXXX
