--------------------------------------------------------------------------------------------------------------------------------------------
--------------------------------------------------------------------------------------------------------------------------------------------
--------------------------------------------------------------------------------------------------------------------------------------------
--------------------------------------------------------------------------------------------------------------------------------------------
----------------------o-------------------------------------------------------o---------------o--o----o-------------------o-----------------
----------o-------o------o---------o----------------o------oo---------o---------o-o-------------o-------o-------o-----------oo--------------
-------------o-o---ooo---------------o---------o-o-----o-o---------------o-----o----------oo--------o---------oo---o----oo-o----------------
--------------o--o-----X?-------o------o----?-----oo-o--o----o---------o-----------S??------o--------o--??-ooo??-X---ooo---X?X--------------
--------o-??X??-S-------------o--o------oo------o-XX-----------o--------XS---o--------o--o---o----o-------o---------------------------------
-------o-o----------------o--o?-?----------------?----------------oooo----o-------------o-----------------??S?----X-------------------------
--------SS-----------------S??----------------------------------S?XS??------------------??--------------------------------------------------
----------------------XXXX--------XXXX----XXXX--------------------------------XXXXXXXX--------XXXX----XXXX----XXXX--------XXXX--------------
XXXXXX----XXXXXXXXXXXXXXXX--------XXXX----XXXX----XXXX----XXXX--------XXXX----XXXXXXXX--------XXXX----XXXX----XXXX----XXXXXXXXXXXX--XXXXXXXX
XXXXXX----XXXXXXXXXXXXXXXX----XXXXXXXXXXXXXXXXXXXXXXXXXXXXXXXX--------XXXX----XXXXXXXX----XXXXXXXXXXXXXXXXXXXXXXXXXXXXXXXXXXXXXXXX--XXXXXXXX
