--------------------------------------------------------------------------------------------------------------------------------------------
--------------------------------------------------------------------------------------------------------------------------------------------
--------------------------------------------------------------------------------------------------------------------------------------------
--------------------------------------------------------------------------------------------------------------------------------------------
----------oo--------o------------------------------------------------------------------------------oo---------------------------------------
------------o---------o-o-------------------o-------------o-o------------------oo-o------------o-oo------------oo---------------------------
------------------oo------o-o-o-----------oo----------------------oo---------o---o-oo-----o----------o--------o---oo---------o--------------
--------o--S-?-o-------o-----------o----o-S-XS-----o--oo---o-o--oo--oo-o----o--------?oo------------------------------o---oo----------------
--------------o-o------------o?X----------------o-o------------o------------------------oo-o-o---------------oX--?---o-oooXX?X--------------
---------o------------------?----------o-o-----o----o---------?S?S???So--o------------?-???X----------oo--o---------------------------------
------?-XX------------------------------------?X-?-SX?-----------------SX?------------------------------?SSSXS------------------------------
XXXXXX----XXXX----XXXX--------------------XXXX------------------------------------XXXX------------XXXX--------------------------------------
XXXXXX----XXXX----XXXXXXXX----XXXXXXXX----XXXX--------XXXXXXXX----------------XXXXXXXX--------XXXXXXXX--------XXXX--------XXXX------XXXXXXXX
XXXXXX----XXXX----XXXXXXXXXXXXXXXXXXXX----XXXX--------XXXXXXXXXXXXXXXX----XXXXXXXXXXXXXXXXXXXXXXXXXXXX--------XXXXXXXXXXXXXXXX------XXXXXXXX
