--------------------------------------------------------------------------------------------------------------------------------------------
--------------------------------------------------------------------------------------------------------------------------------------------
--------------------------------------------------------------------------------------------------------------------------------------------
--------------------------------------------------------------------------------------------------------------------------------------------
--------------------------------o-o------------------------------------oo-----------------oo---------------o-o------------------------------
----------------o------o----------------------o-------------oo-----o-oo---------------------o-o--oo--o----o------------------o--------------
--------------o-------o-------oo-----o------o---o--o-----ooo--------o---------------------------------------------o--o----------------------
-------ooo---o-o---o-o------o-??X-XX?Sooo--o-o-o-oo-------------------XX--o-o-ooo---o----o?X-S-----oo-----XX-?oo---o--ooo-o-o---------------
----------o-o-?---o-o------------------------X?S-S----o--------oo-??SX-------o-----o----------X-------o-----------?--------?S---------------
-----------o---------------o-o--------------------X?-SX-?-------?---------S-------o----oo-----------------------oo------?-------------------
----------XSX--------------XS?--------------------------------------------------------X-S?--------------?-----??-X--------------------------
------------------------------XXXXXXXX--------------------XXXX--------XXXX----------------XXXX------------XXXX----------------XXXX--XXXXXXXX
--------------XXXX----XXXX----XXXXXXXX----XXXXXXXX--------XXXX----XXXXXXXX----XXXX--------XXXXXXXXXXXX----XXXX----XXXX----XXXXXXXX--XXXXXXXX
XXXXXXXXXX----XXXXXXXXXXXX----XXXXXXXXXXXXXXXXXXXXXXXXXXXXXXXXXXXXXXXXXXXXXXXXXXXX--------XXXXXXXXXXXX----XXXX----XXXXXXXXXXXXXXXX--XXXXXXXX
