--------------------------------------------------------------------------------------------------------------------------------------------
--------------------------------------------------------------------------------------------------------------------------------------------
--------------------------------------------------------------------------------------------------------------------------------------------
--------------------------------------------------------------------------------------------------------------------------------------------
---------o------------------o---------------o------------------------------o---------o----------o-o-----------------------------------------
---------------------------o-o--------ooooo--o----o------------------------------oo-o-----oo--------o--o------------------------------------
-------oo----------o--oo-------------------------o-o-o------o------o-o----------o--------------o---o-o--o-----------------ooo---------------
-------??So--o---o---------?--oo--o----------S-o-------o-o----o-o-o-o---o-X----o----------------------------o--o--o-oo---o------------------
-----------?X?------o------------o---o------------?-X-o---oo-o-o---SX-o---------------oo-o-------------?-X-o--o---------o---X---------------
--------------o-----------------o--------------S-S--------------?-----------------------o--------------------o---------o--------------------
--------------SS?-------------S?XX?-----------------------------------SX?-------------X-X-----------------??S?X-X?------?X------------------
XXXXXXXXXX----------------XXXX------------XXXX----------------------------XXXX----XXXX--------XXXXXXXX------------------------XXXX----------
XXXXXXXXXXXXXX--------XXXXXXXX--------XXXXXXXX----XXXX------------XXXX----XXXXXXXXXXXX----XXXXXXXXXXXXXXXX----------------XXXXXXXXXXXXXXXXXX
XXXXXXXXXXXXXX----XXXXXXXXXXXX--------XXXXXXXXXXXXXXXXXXXXXXXXXXXXXXXX----XXXXXXXXXXXX----XXXXXXXXXXXXXXXX--------XXXX----XXXXXXXXXXXXXXXXXX
