--------------------------------------------------------------------------------------------------------------------------------------------
--------------------------------------------------------------------------------------------------------------------------------------------
--------------------------------------------------------------------------------------------------------------------------------------------
--------------------------------------------------------------------------------------------------------------------------------------------
---------o------o---------------------------------ooo---------------------------oo--------------------oo------------------------------------
--------o--o---o----o-----------o---------------oo----o-------------------o------------oooooo---------------------o-----oo---o--------------
------------o------o-------o-----------------o-o------------o-------oooooo---ooo-----------------o------------o-----o-oo---o----------------
-------X?Xo-------o----oo-o-oo-o----------o-o----S????-?-?o-----o--------------------o-?-?---------------?-----oo--o-o---Xo-----------------
----------S-S------------X----X---o--ooooo-----------------o------?---?XS?----------o-----X?-?------o-----o-------?-------SS-X--------------
---------------------------X?S--------------------------------o-------------------oo----------S----o-o------ooXXS---------------------------
--------------------------------------------------------------S-X------------------S-X-----------------------?------------------------------
XXXXXXXXXX----XXXX----------------------------XXXXXXXXXXXX----------------XXXXXXXX----XXXX------------XXXX------------XXXX------------------
XXXXXXXXXXXXXXXXXXXXXXXXXX----XXXX------------XXXXXXXXXXXX--------XXXXXXXXXXXXXXXX----XXXXXXXX--------XXXX--------XXXXXXXXXXXX--------------
XXXXXXXXXXXXXXXXXXXXXXXXXXXXXXXXXXXXXXXXXXXXXXXXXXXXXXXXXXXXXX----XXXXXXXXXXXXXXXX----XXXXXXXXXXXX----XXXX----XXXXXXXXXXXXXXXX----XXXXXXXXXX
