--------------------------------------------------------------------------------------------------------------------------------------------
--------------------------------------------------------------------------------------------------------------------------------------------
--------------------------------------------------------------------------------------------------------------------------------------------
--------------------------------------------------------------------------------------------------------------------------------------------
-----------------------o---------------------------------------o----------------------o--o------------------o-------------------------------
---------------o---------------o--------o-----------------------o------o------ooo----o--o--oo-------o-----o--o--------o---------------------
----------o------o-------o---oo------oo---o-o---oo-o-------------o---------o-------o------o---o---oo-ooo-o-o--oo-----o--oo------------------
-----------o-------------?-------------o---o---o--o-----o--o--------ooo--oo--o---------XXS?SS-----------o-????S?X------o--o--o--------------
------oo-----------o-o----X--?X-?X-oo---------X-?-S??S------o---------????X-?-------------------o-------??-----------------o----------------
---------o????----o-o--------------XS--------X-----------o--------o---------------------------------------------------------o---------------
------XS?X--------------------------------------------?--X--------S-XS------------------------------------------------------?S--------------
----------------------XXXX------------------------------------XXXX--------------------XXXXXXXX------------XXXXXXXX--------------------------
--------------XXXX----XXXXXXXXXXXX----XXXX----XXXXXXXX--------XXXX----XXXXXXXXXXXXXXXXXXXXXXXX----XXXXXXXXXXXXXXXXXXXXXXXX----XXXX----------
XXXXXX----XXXXXXXX----XXXXXXXXXXXXXXXXXXXXXXXXXXXXXXXX--------XXXX----XXXXXXXXXXXXXXXXXXXXXXXXXXXXXXXXXXXXXXXXXXXXXXXXXXXX----XXXXXXXXXXXXXX
