--------------------------------------------------------------------------------------------------------------------------------------------
--------------------------------------------------------------------------------------------------------------------------------------------
--------------------------------------------------------------------------------------------------------------------------------------------
--------------------------------------------------------------------------------------------------------------------------------------------
--------------------------------------------o----------------o----oo---o----------------------------o----o----------------------------------
-------o-o-----------------------------o--o----------------o--ooo----oo---------o--------------------o---------o-----o----------------------
--------o--o-----o--o--------------------o------o--oo---------------o-----o---------o-------------oo----------o----o----o--o-o--------------
------------o-----oo-o-----o-o-------------??--------o-o-o--------S??X-?------oo-o---o----o---o--------?S-------o---------o-----------------
------S?-?o--oo-------o--------oo--------S-------oo-----o-------------------------o-----oo-o-o--o-----------o-???X?---o--o------------------
----------?X--------------???-o---oo-o--------??S--?--?-----------------------------S-----X-XX------------o--o-----------??-?---------------
-----------------------??S----?-------------------------------------------------------XX?-----S-----------?X-?------------------------------
------------------------------------------XXXX------------XXXXXXXXXXXXXXXX------------------------XXXXXXXX----------------------------------
XXXXXXXXXX--------XXXX----------------XXXXXXXX------------XXXXXXXXXXXXXXXXXXXXXXXX----------------XXXXXXXX----XXXXXXXX------------XXXXXXXXXX
XXXXXXXXXXXXXXXXXXXXXX----XXXX--------XXXXXXXXXXXXXXXXXXXXXXXXXXXXXXXXXXXXXXXXXXXXXXXX----XXXX----XXXXXXXX----XXXXXXXXXXXXXXXX----XXXXXXXXXX
