--------------------------------------------------------------------------------------------------------------------------------------------
--------------------------------------------------------------------------------------------------------------------------------------------
--------------------------------------------------------------------------------------------------------------------------------------------
--------------------------------------------------------------------------------------------------------------------------------------------
---------------------------------------------------------------------o--------o-o-----------------------------------------------------------
----------------------oo-----o-----o-o-----ooo-o-o-----------------oo----------o-o---------o------oo-o----------------o-oo------------------
--------------------------o------o--o-----o---o-o--o------------------------------o--o-oo----o---o--o-----o--oo-----------------------------
-----------o-------oo-------o-o-------------------o-------oo----o-?--S--o-oo-------o--------o----------o----o---o------o--o-----------------
-------oooo--o-o--o--o---???SXS?S?----oo-----S?S???S?S------oo---------o-o----------------??-----------S-X-o--X?S----o--X-------------------
------??SS???S-X?-----------------------oo-----------------------------------o-----XS?X?-?----------------X??S-------------o-o--------------
----------------------------------------------------------------------XS?X----------------------------------------?---------S---------------
----------------------------------XXXX----------------------------XXXX--------XXXX----------------XXXX--------------------------------------
----------------------XXXXXXXXXXXXXXXX----XXXXXXXXXXXX--------XXXXXXXX--------XXXX--------XXXX----XXXXXXXX----XXXX----XXXX------------------
XXXXXXXXXXXXXXXXXXXXXXXXXXXXXXXXXXXXXX----XXXXXXXXXXXXXXXXXXXXXXXXXXXX--------XXXXXXXXXXXXXXXXXXXXXXXXXXXXXXXXXXXX----XXXX--------XXXXXXXXXX
