--------------------------------------------------------------------------------------------------------------------------------------------
--------------------------------------------------------------------------------------------------------------------------------------------
--------------------------------------------------------------------------------------------------------------------------------------------
--------------------------------------------------------------------------------------------------------------------------------------------
----------------------------------------------------o------------------o-o------o-----oo----o---------------------------oo------------------
-----------------o----o-----o-------------oo------o-------------------o--------o-------------o----------------------o-oo--------------------
------------o-ooo--------o---o-o----o---o----------o-o---o--o-------oo------o-o--o------oo-o----o---o--o------------------oo----------------
----------oo-oXX--o---------X-o-o----ooo--????--o---XXo---oo--oo--o---?SX----------o--????-?S?---ooo--------------------?---o---------------
---------------------o-------------o-----o----o--o-----------------o---------o--------------------------oo--o-o--------------o--------------
--------oo?S?X-----oo---------X-X?XS----------?-XS----?S------------S?----S---------------------X------S-X---o-o----------?--?--------------
-------X-?------------------------------------------------------------------------------------------------S-?-------------------------------
--------------XXXX----XXXXXXXX------------XXXX----XXXX----------------XXXX----XXXX----XXXXXXXX------------------------XXXX--------XXXXXXXXXX
--------------XXXX----XXXXXXXX------------XXXX----XXXX----XXXX--------XXXX----XXXX----XXXXXXXX----XXXX------------XXXXXXXX--------XXXXXXXXXX
XXXXXX----XXXXXXXX----XXXXXXXXXXXXXXXXXXXXXXXXXXXXXXXXXXXXXXXX----XXXXXXXXXXXXXXXX----XXXXXXXXXXXXXXXXXXXX--------XXXXXXXXXXXXXXXXXXXXXXXXXX
