--------------------------------------------------------------------------------------------------------------------------------------------
--------------------------------------------------------------------------------------------------------------------------------------------
--------------------------------------------------------------------------------------------------------------------------------------------
--------------------------------------------------------------------------------------------------------------------------------------------
------------------o-o-------------------------------------------o---o-------------o------o--------------------------------------------------
------------------------------o-----o----------------------------o----o---------------oo----------o-o---------------------o--o--------------
--------oo----oo---o----o-------o-----ooo-------o----------o--o---o----o-------------o-----oooo-o---------ooo--o-o-------o------------------
-------o--o---?---------------??SS------------o--o----------o-----S--------o--o------X?-??o--------o--o------o-----o--o----o----------------
-----------oo---------------oo------------o-------o----o-oo-----------?X?---oo--o-------------------------???So------o-o--?-----------------
-------------o-----------?--------------------?--S-o-oo---S----------------------o--------X-??----------------S-??-------S------------------
----------X???------------?XX--------------?-S----X??SSS?-----------------??--------------------------------------??------------------------
--------------XXXXXXXX--------XXXXXXXX------------------------XXXXXXXX------------XXXXXXXX----XXXX------------------------------------------
XXXXXXXXXX----XXXXXXXX--------XXXXXXXXXXXX--------------------XXXXXXXXXXXX--------XXXXXXXX----XXXXXXXXXXXXXXXX------------XXXXXXXXXXXXXXXXXX
XXXXXXXXXX----XXXXXXXXXXXX----XXXXXXXXXXXX----XXXX--------XXXXXXXXXXXXXXXX--------XXXXXXXXXXXXXXXXXXXXXXXXXXXXXXXX----XXXXXXXXXXXXXXXXXXXXXX
