--------------------------------------------------------------------------------------------------------------------------------------------
--------------------------------------------------------------------------------------------------------------------------------------------
--------------------------------------------------------------------------------------------------------------------------------------------
--------------------------------------------------------------------------------------------------------------------------------------------
----------o-------------------------------o----------------o-o---------o------------------------------o----------o--------------------------
-------------------o----------o------------o-o--------------o------o--o----------------o---o----o-------o------o----------------------------
------o-o---------o-----o---o--o----------------o---------o---------o------o----------o--o-----------o---o----o-----------------------------
-----------?--------oo-o-o-o-o--o-------o--------o---oo---X-------o---????-S--o--o-----?X?o-oo------o----------??----o----o--o--------------
-------o-o------------o---X-???-??----o------------oo---------o---?X-?---------oo---------??------oo--------oo-----o--o--o-o----------------
------S--S--------------?-----------o-----------?-o-----o-------oo----------------o-----------------------oo------o----oo-------------------
----------------------------------X?--------------?SXSX-?X-------?---------------?-?-----------------------SS?----------?S---X--------------
----------XXXX----------------------------XXXX------------XXXX--------XXXXXXXX--------XXXX------------XXXX----XXXX--------------------------
----------XXXXXXXXXXXX----XXXXXXXX--------XXXX------------XXXX----XXXXXXXXXXXX--------XXXXXXXXXXXX----XXXX----XXXX--------------------------
XXXXXXXXXXXXXXXXXXXXXXXXXXXXXXXXXX--------XXXXXXXX--------XXXX----XXXXXXXXXXXX--------XXXXXXXXXXXXXXXXXXXX----XXXX------------XXXXXXXXXXXXXX
