--------------------------------------------------------------------------------------------------------------------------------------------
--------------------------------------------------------------------------------------------------------------------------------------------
--------------------------------------------------------------------------------------------------------------------------------------------
--------------------------------------------------------------------------------------------------------------------------------------------
--------------------o--o---oo--oo-------------------------------------------------------------------------------------------o---------------
--------------o--o---oo-o---------o------------o-oo--------o-------o-o--o---o-------o-----o------------------------o-------o----------------
---------------o---o------o--o---o--o------------------o--o-oo-oo---o-----o-------o----------o--------------o--------oooo-o--o--------------
--------o-oo-------------????-???--?----oo------o---oo----------------o-------o----??--oo--o--X---ooo---o--o--------o----?-???--------------
----------S??--------------------------o--o----?SS?S-?---o---S---o--X?S-??-X---oo--------o-?X--------oo---o-----oo--------------------------
---------o----------------------------o-------------------------------------------------------------------X?-?oo----------------------------
---------?----------------------------------------------------------------------------???---------------------X-----------------------------
------------------XXXXXXXXXXXXXXXXXXXX--------------------------------------------XXXX--------XXXX--------------------XXXXXXXX--------------
XXXXXX----XXXXXXXXXXXXXXXXXXXXXXXXXXXX--------XXXXXXXX----XXXX----XXXXXXXXXXXX----XXXX----XXXXXXXX----------------XXXXXXXXXXXX--------------
XXXXXX----XXXXXXXXXXXXXXXXXXXXXXXXXXXX----XXXXXXXXXXXXXXXXXXXXXXXXXXXXXXXXXXXX----XXXX----XXXXXXXX--------XXXX----XXXXXXXXXXXXXXXX--XXXXXXXX
