--------------------------------------------------------------------------------------------------------------------------------------------
--------------------------------------------------------------------------------------------------------------------------------------------
--------------------------------------------------------------------------------------------------------------------------------------------
--------------------------------------------------------------------------------------------------------------------------------------------
----------------------------------------------------------------------------------------------oo------o-------------------------------------
------------------oooo--------------o---------o---o-----------------------o----------------------o--------------o---------------------------
-----------o-------------------oo-----oo------------------o---o-oo--oo-----oo-oooo---o----------o-------o-----o-------o-oo------------------
-------o--o--oo----------o--ooo---------o----o---o-oo-oo-o-o-o---------o----------ooo---o-oo------oo---?-?-o-o?-----------------------------
-----------------------o--?XXXX----------oo----?SSX??S----?S----------o---???----------o----oo------o--------------------?o-----------------
--------oo?-?X---o-----??X-----------------------------SX?-------------------------SX?o--o-----------o----S??--------o----------------------
-------?-X----XS?-----------------------------------------------------???-------------?XX?---S-------S--------------------S--?--------------
----------------------------------XXXX--------------------------------------------------------XXXX----XXXX----XXXX----------------XXXXXXXXXX
------------------XXXX----XXXXXXXXXXXX--------XXXXXXXX----XXXXXXXXXXXX----XXXX----------------XXXX----XXXX----XXXX----XXXX----XXXXXXXXXXXXXX
XXXXXX----XXXX----XXXXXXXXXXXXXXXXXXXXXXXX----XXXXXXXXXXXXXXXXXXXXXXXX----XXXXXXXXXXXX--------XXXX----XXXXXXXXXXXX----XXXX----XXXXXXXXXXXXXX
