--------------------------------------------------------------------------------------------------------------------------------------------
--------------------------------------------------------------------------------------------------------------------------------------------
--------------------------------------------------------------------------------------------------------------------------------------------
--------------------------------------------------------------------------------------------------------------------------------------------
----------------o---------------o--ooo----------------------------------------------------------oo-------------o----------------------------
--------------o----------------o------o--o----------o----------------------------o----------------------------------------------------------
------o-oo-----o-o-----------oo--------oo-----oo--oo-o------o-----------o-----o-o--------o---oo---------------o-----------------------------
----------o---??----------oo--X--S?-S-X---------------o---------o-o-o-o------o-o----o---o-o---?-S--o-o-----o-o?X-S---------ooo--------------
-----------o-o-----o-------?SX---------------o--oo--?X---o-o-o-----o---o----------o----o------------o------------------o-o-SS---------------
-------XX?--------o-o-o-----------------------X--?----------------S--?X-??----------------SS?---------oooo--o---------o-o-------------------
----------X???---------SS--------------------------------------------------S-----------------------------?S??-----------?-------------------
--------------XXXX------------XXXXXXXXXXXX----------------------------------------------------XXXX------------XXXXXXXX----------------------
--------------XXXX--------XXXXXXXXXXXXXXXX--------XXXX------------------------XXXX------------XXXX------------XXXXXXXX----XXXX--------------
XXXXXXXXXX----XXXX--------XXXXXXXXXXXXXXXX----XXXXXXXX----XXXXXXXXXXXXXXXX----XXXX----XXXXXXXXXXXX------------XXXXXXXX----XXXXXXXXXXXXXXXXXX
