--------------------------------------------------------------------------------------------------------------------------------------------
--------------------------------------------------------------------------------------------------------------------------------------------
--------------------------------------------------------------------------------------------------------------------------------------------
--------------------------------------------------------------------------------------------------------------------------------------------
-------o-------------------------------oo-o-------------------------------------------------------------------------------------------------
---------o-------------o--o---o--o----o--o-o-----o---o--o-----oo----oo--------------------oo----------o-o----o------------------------------
----------------------o-oo--o--o-------------------oo-----oo------o----o-----o------------------oo----------o-------------------------------
------?S?----o----o----------oSXS----------??Xo---o------o--oo--o--???o----o---ooo--oo-------o-o---------------oo-o--ooooo------------------
----------o--------oooS--??SX?-------o---------???XSSXS--------?-?------o--?X-----------oo?--?o----o----------o--o---------o----------------
------------o---------------------o-----------------------------------?XXX----o---------------------o----------XX?--------o--o--------------
--------------------------------------------------------------------------------------?SX?--------S---------------?-----S-??SS--------------
XXXXXXXXXX----XXXX------------XXXX----XXXXXXXX--------------------XXXX--------------------------------XXXX--------------------XXXX----------
XXXXXXXXXX----XXXX----XXXXXXXXXXXX----XXXXXXXXXXXXXXXXXXXX----XXXXXXXX----XXXX----XXXX----XXXX--------XXXXXXXX----------------XXXX----------
XXXXXXXXXX----XXXX----XXXXXXXXXXXX----XXXXXXXXXXXXXXXXXXXXXXXXXXXXXXXXXXXXXXXX----XXXX----XXXXXXXX----XXXXXXXXXXXX------------XXXXXXXXXXXXXX
