--------------------------------------------------------------------------------------------------------------------------------------------
--------------------------------------------------------------------------------------------------------------------------------------------
--------------------------------------------------------------------------------------------------------------------------------------------
--------------------------------------------------------------------------------------------------------------------------------------------
--------------------o------------------oo------------------------------o---o----------------o--------------o--------------------------------
---------o-----------o---------ooo----------o-------------------------o-----o----o---------o-o--------------o-o-----------------------------
------------------oo-------oo------oo----o-o------o---------------------------ooo-oo-o----o----o-------------o--o----------oo---------------
------S?XS--o-oo-------------oS?X?-------?X??X---o-o-----o-o-oo-------S???---------------o----o--o-oo-o-o-??XX-SX?--------------------------
-----------o-o--o-----o--o-?S?--------------------X?-----------ooo--o-----------------o---------o-o------------------o----o--o--------------
--------------?X-------------------------------o------o---o-o-----oo-o--------------?X----------------?-XS--------?-----o-??-?--------------
----------SXXS--------------------------------S-S?------------XS-SSS?------------------S--------------------------------X?------------------
XXXXXXXXXX--------XXXX--------XXXX----XXXXXXXX------------------------XXXXXXXX------------XXXX------------XXXXXXXX--------------------------
XXXXXXXXXX--------XXXX----XXXXXXXX----XXXXXXXX----XXXX----------------XXXXXXXXXXXX--------XXXX------------XXXXXXXX------------XXXX--XXXXXXXX
XXXXXXXXXX----XXXXXXXX----XXXXXXXXXXXXXXXXXXXX----XXXX----------------XXXXXXXXXXXXXXXX----XXXXXXXXXXXXXXXXXXXXXXXXXXXX----XXXXXXXX--XXXXXXXX
