--------------------------------------------------------------------------------------------------------------------------------------------
--------------------------------------------------------------------------------------------------------------------------------------------
--------------------------------------------------------------------------------------------------------------------------------------------
--------------------------------------------------------------------------------------------------------------------------------------------
------------------------------------------------o----------------------------------------------------------o-------o------------------------
----------oo-------------------------------------o--------o-o-----------------------o---------------------o----o-------oo--oo---------------
--------o------oo---o-------o-o------o------------oo--o--o---o----------------o-o------o-o--------oo-o---o--oo------oo-------o--------------
-------------------o----------------------o---?-X?---o-------X------o----o---o-o--oo------o--o------------?S-?o--o----o--oo-----------------
-------o-o?S?X---o----o---o--o-oo--o---------o-----??---------S--?---o-oo--------o------o--o----o---o--o-------?-X------X-SSS?--------------
-------?SS------X------o---SSS?X?S----oooo-o---------------------------?S---o---------X??X--o--o-o-------S----------------------------------
--------------------------------------------??--------------------???X--------------------??------------------------------------------------
----------------------------------------------XXXX--------XXXX--------------------------------------------XXXX----XXXX----------------------
----------XXXX----XXXX------------------------XXXXXXXX----XXXXXXXX----------------XXXX--------------------XXXXXXXXXXXXXXXXXXXX--------------
XXXXXXXXXXXXXXXXXXXXXX----XXXXXXXXXXXX--------XXXXXXXXXXXXXXXXXXXX----XXXX----XXXXXXXXXXXX--------XXXXXXXXXXXXXXXXXXXXXXXXXXXX----XXXXXXXXXX
