--------------------------------------------------------------------------------------------------------------------------------------------
--------------------------------------------------------------------------------------------------------------------------------------------
--------------------------------------------------------------------------------------------------------------------------------------------
--------------------------------------------------------------------------------------------------------------------------------------------
------------------o-oo--------oo-------------------ooo--------------------------------o--o--------------------------------------------------
----------o-----------o---o--------------o------------------------------------------------o-------o--o----------o------oo--o----------------
-----------o-------o---o-o------o------o------oo--------ooo------------------------oo--o---o-------o----------o-------------o---------------
-------o-o??S?oo-----S-------o?-S--o--o-o---------X-?----------o-o-o-oo--------o--o--o-?S?--o-------o---------SS?---------o--o--------------
---------?-------o--------??XS------o----X--o---oo---------ooo------o---o-o---o-oo---?----??S------------o---o-------o----?-XX--------------
------------------------------------------?X--??XS-----------------------o---------------------o-o---------oo-------------------------------
----------------?-----------------------------------------------???-S?XS-X--------------------X?-----------X?X------------------------------
----------XXXX----XXXXXXXX----XXXX----------------XXXX--------------------------------XXXX--------------------XXXX----------------XXXXXXXXXX
XXXXXXXXXXXXXX----XXXXXXXXXXXXXXXX----XXXX--------XXXX----------------------------XXXXXXXXXXXX----XXXX--------XXXX----XXXXXXXX----XXXXXXXXXX
XXXXXXXXXXXXXX----XXXXXXXXXXXXXXXX----XXXXXXXXXXXXXXXXXXXXXXXX------------XXXX----XXXXXXXXXXXX----XXXX--------XXXXXXXXXXXXXXXXXXXXXXXXXXXXXX
