--------------------------------------------------------------------------------------------------------------------------------------------
--------------------------------------------------------------------------------------------------------------------------------------------
--------------------------------------------------------------------------------------------------------------------------------------------
--------------------------------------------------------------------------------------------------------------------------------------------
----------------------o----------------------------------------------------------o-----o--oo-----------------------o-o----------------------
-------------------------o-------------------------------o---------------o-----oo--------o--o-----------o---------o-------------------------
--------o---o-------------------------------------o---o----o----o---o-o----o------------o-----o---------------------o-----------------------
----------oo----o---------ooo--o------o--oo---o--o----?---o--o-----o-o--------------o--??-?-??-o---o-oo------o----------o-o-o---------------
------oo-o-X??o------o-------oo--ooo-o-o--------------------o-----o---XSS------------------------o------X---o---o-----oo---o-o--------------
--------??---------oo-------------------o------??--S??----------SX?X-S----X?------------------S---o-o---------oo-o------?-------------------
--------------XS-----------X?S?SS-?-----------------------------------------------------------------------???S-X?X---------?-X--------------
----------------------XXXX----------------------------XXXX--------------------XXXX----XXXXXXXX--------------------XXXX------------XXXXXXXXXX
----------XXXX--------XXXX----------------------------XXXX------------XXXX----XXXX----XXXXXXXX--------XXXX--------XXXX------------XXXXXXXXXX
XXXXXXXXXXXXXX--------XXXX----------------XXXXXXXXXXXXXXXXXXXXXXXXXXXXXXXXXXXXXXXXXXXXXXXXXXXXXXXX----XXXX--------XXXXXXXX--------XXXXXXXXXX
