--------------------------------------------------------------------------------------------------------------------------------------------
--------------------------------------------------------------------------------------------------------------------------------------------
--------------------------------------------------------------------------------------------------------------------------------------------
--------------------------------------------------------------------------------------------------------------------------------------------
----------------------o------------------------------------o------------------------------oo------------------------------------------------
------------------o-o-------o-----------oo----------------o-o-------o-----------------------o--o-o-----------------o------------------------
-------------------o-o----------------o-----------o----------o-----------o-----o----------------o--o--------o---oo---o----------------------
--------oo--o-------------o--o----o---------ooo-o--?---------?-----o-ooo----oo--o---------S--?------o-o------o----SX?--o--oo-o--------------
----------------o----------?-So-o--o--------------------o-----oo--S-??--------o----------o--------o--o-----S?So-------o-oo?XX?--------------
--------?--o-o-o-o-------------o---?-?----o----o-o----o---------o------??-----------o-------------------------?-?X------XS------------------
-----------X-SS---------------S??------------X-XS?------------???-----------------?-SS?-??--------------------------------------------------
------------------XXXXXXXX------------XXXX--------XXXX----XXXX----------------------------XXXXXXXX----------------XXXX----------------------
------------------XXXXXXXXXXXX--------XXXX--------XXXX----XXXX----XXXX----XXXX------------XXXXXXXX--------XXXX----XXXX----XXXX----XXXXXXXXXX
XXXXXXXXXX--------XXXXXXXXXXXX----XXXXXXXX--------XXXX----XXXX----XXXXXXXXXXXXXXXX--------XXXXXXXXXXXX----XXXXXXXXXXXXXXXXXXXX----XXXXXXXXXX
