--------------------------------------------------------------------------------------------------------------------------------------------
--------------------------------------------------------------------------------------------------------------------------------------------
--------------------------------------------------------------------------------------------------------------------------------------------
--------------------------------------------------------------------------------------------------------------------------------------------
------------oo---------o-------------------------------------------o-o----oo----------o--o----------------------oo-----o--------------------
---------o-o---------------o----ooo----------------------o------------------o----------oo------------o---------o----------------------------
-------o--o------o-oo--------o-----o---o---------------o------oo----o-o-oo---o---------------o-----oo---------o-------o-oo------------------
----------?X----o--------?----?--S---o------------o--oo-o-o-----o--??--o--XX-------------?-o---------------o---??--------S-o----------------
------SX-S----o---o-------XSS?----S------o---------oo-S-----oo--------??XS-----o-oo--o----o-----oo-----------o----o--o-------o--------------
-------------------------------------------------oS??X-----o----?S--------------o---------SX?X-X?-----o--oo--------o------o-----------------
-----------------------------------------------X-?-----------------------------------------------------?XS????------------XSX?--------------
----------XXXX--------XXXX----XXXX--------XXXX--------------------XXXX----XXXX--------XXXX--------XXXX--------XXXX----XXXX------------------
XXXXXXXXXXXXXX--------XXXXXXXXXXXXXXXX----XXXX--------XXXX--------XXXXXXXXXXXX--------XXXX--------XXXX--------XXXX----XXXX------------------
XXXXXXXXXXXXXXXXXXXXXXXXXXXXXXXXXXXXXXXXXXXXXX----XXXXXXXX----XXXXXXXXXXXXXXXX--------XXXXXXXXXXXXXXXX--------XXXX----XXXX--------XXXXXXXXXX
