--------------------------------------------------------------------------------------------------------------------------------------------
--------------------------------------------------------------------------------------------------------------------------------------------
--------------------------------------------------------------------------------------------------------------------------------------------
--------------------------------------------------------------------------------------------------------------------------------------------
----------------------oo----------------o----------------------------------o----o-----------------o-----------------------------------------
----------o--o-------------o--------------------------------o-o-----------o-------o-o----------o----o--o---------------oo-------------------
------o----oo---o--o----o----------ooo-o-------------------o-o----------------oo----------------o--o--o-o----o-o---o------------------------
----------XXXX------o-----o-oo------------o-----------o-------------ooo----?-?-----o----o--------o-----------Xo----------o------------------
--------oo----?X??o--o--------oo-------------oo--o-o---------------o--------------?------ooo----?--------------S--------X?o-----------------
------??S?--------------------X-?--------------oo-o---X--?-------------o--------------------o-------------------------------?---------------
---------------------------------------------S?-????---------------S????S-------------??X???------------------------------------------------
----------XXXX--------XXXX------------XXXX----------------XXXX------------XXXXXXXX----------------XXXXXXXXXXXX----XXXX----------------------
----------XXXXXXXX----XXXXXXXX----XXXXXXXX----------------XXXXXXXX--------XXXXXXXXXXXX--------XXXXXXXXXXXXXXXXXXXXXXXXXXXX--------XXXXXXXXXX
XXXXXXXXXXXXXXXXXXXXXXXXXXXXXXXXXXXXXXXXXX------------XXXXXXXXXXXX--------XXXXXXXXXXXX--------XXXXXXXXXXXXXXXXXXXXXXXXXXXXXXXXXXXXXXXXXXXXXX
