--------------------------------------------------------------------------------------------------------------------------------------------
--------------------------------------------------------------------------------------------------------------------------------------------
--------------------------------------------------------------------------------------------------------------------------------------------
--------------------------------------------------------------------------------------------------------------------------------------------
-----------------------------------------------------------ooo----------------------------------------------------oo--o----o----------------
------------oo---------------------------o-------ooo----------------o------ooo---o----------------------------------------o-----------------
-------ooooo---o-o-o-o----------------ooo----o------------o----o------o--o----o-o--o-o-------------------------ooo-----o-o------------------
----------------o-o-----ooo--o------oo------------?X---o-----------o-o-o--?----o--o----------o----------ooo--oo---------?-S???--------------
-------S-XS--XX?----o------o--o-------------o--SXS-----------------?-??XXX-----------?-o-oo--------o-o------o-------------------------------
--------------------------??SS---o-o---------?--------------------------------------------------------oo------S??---------------------------
------------------------------XSSXS-------------------XX?-----------------------------SS-?S-??-----------?-?X-------------------------------
--------------------------------------------------XXXX----XXXXXXXX--------XXXX------------------------------------XXXXXXXXXXXX----XXXXXXXXXX
XXXXXXXXXXXXXXXXXX----XXXX------------XXXX----XXXXXXXX----XXXXXXXXXXXXXXXXXXXXXXXXXXXX--------XXXX----------------XXXXXXXXXXXX----XXXXXXXXXX
XXXXXXXXXXXXXXXXXXXXXXXXXXXXXX--------XXXXXXXXXXXXXXXX----XXXXXXXXXXXXXXXXXXXXXXXXXXXX--------XXXX------------XXXXXXXXXXXXXXXXXXXXXXXXXXXXXX
