--------------------------------------------------------------------------------------------------------------------------------------------
--------------------------------------------------------------------------------------------------------------------------------------------
--------------------------------------------------------------------------------------------------------------------------------------------
--------------------------------------------------------------------------------------------------------------------------------------------
-------------------------------------o-----------o----------------------------------o-o-oo-------o-o----------------------------------------
----------o-----------------------oo---------oo-o-----o------------------------o--oo-----------------o-o------------------------------------
------o----------o--------------------o-o-oo---o-----o-o-o--o---------o-o-----o-oo-----o------------o---o-------o--------o------------------
--------o--oo-oo----o-------o-o--o-----o----o--SSXooo--------------o---------o-----X????-X---------------oo----o-o----o-o-------------------
-------o-oS-?-----o---X?X?-----S??------------------------oo-o---------o--???-------------oo----------------o-?X-?-----o--o-o---------------
---------X------------------------------------------?---------------o-S??X---------------------------------o-------o----X?-o----------------
--------------------------XSS?-------------------------------------???--------------------S?XX--------------SX------------?-----------------
----------------------------------XXXX--------XXXX----------------------------XXXXXXXXXXXX----XXXXXXXX--------------------------------------
----------XXXX--------XXXX----XXXXXXXX----XXXXXXXX----XXXX----------------XXXXXXXXXXXXXXXX----XXXXXXXXXXXX----XXXX----------------XXXXXXXXXX
XXXXXXXXXXXXXXXXXXXXXXXXXX----XXXXXXXXXXXXXXXXXXXXXXXXXXXXXXXXXXXX----XXXXXXXXXXXXXXXXXXXX----XXXXXXXXXXXX----XXXX----XXXX----XXXXXXXXXXXXXX
