--------------------------------------------------------------------------------------------------------------------------------------------
--------------------------------------------------------------------------------------------------------------------------------------------
--------------------------------------------------------------------------------------------------------------------------------------------
--------------------------------------------------------------------------------------------------------------------------------------------
----------------------------o----o-oo--o-o----------------------------------------o--o---o----------oo--------------------------------------
-------------------------------o------o-o-----------------o-oo--o----------o------------o----------o----o----o------------------------------
------oo-----------oo--------oo-o-o----------o--o------o----------o--o-o--o--o-------------o------o--------oo-------o-------o---------------
----------oo---------oo--o-?-?-?XXX?-X----o----o---------o-o--------o----o??-X--o-------X-o------------?--?S?------o------------------------
--------oo-------o------o---------------------o--o-o--o-----------?X?Xo-o------o----------?-X?oo-o-------------o--o----ooooo----------------
--------X-------------------------------------X-X?SSX?-?--------------X?------o---------------X??X------------o-------o---X-----------------
----------X?-S------------------------------------------------------------------------------------------------??S--------?------------------
--------------------------XXXXXXXXXXXXXXXX--------------------XXXX--------XXXX----XXXXXXXX--------XXXXXXXXXXXX------------------------------
------------------XXXX----XXXXXXXXXXXXXXXX----------------XXXXXXXXXXXX----XXXX----XXXXXXXXXXXX----XXXXXXXXXXXX------------------------------
XXXXXXXXXX--------XXXX----XXXXXXXXXXXXXXXXXXXXXXXXXXXXXXXXXXXXXXXXXXXXXXXXXXXX----XXXXXXXXXXXXXXXXXXXXXXXXXXXX----XXXX----XXXX----XXXXXXXXXX
