--------------------------------------------------------------------------------------------------------------------------------------------
--------------------------------------------------------------------------------------------------------------------------------------------
--------------------------------------------------------------------------------------------------------------------------------------------
--------------------------------------------------------------------------------------------------------------------------------------------
--------------o--o-----------o-----o-o------------------------------------------------------------------------------------------------------
-------ooo---------o--oo---o--oo-o--------oo--------oo-------------o------------o----------o---------oo---o--o------------------------------
------o---oo-o-o----o-------o---------------------oo----o------------o-------o-o-o------o----------oo---o-----o-o---------------------------
-------XXSS????---o--o-?????-X----S----o-o---------S---o-----oo---o----o-oo---o-----oo---o--oo----o---------o--o------oo-oo-o---------------
------------------------------XSX?--------X--X-oo---------ooo--o-----?o---XX--------------SS?--o------??--?SX?-------o-------o--------------
--------------------------------------o----------o----?--------------------------------???----o--o------------SX---------S------------------
-----------------------------------------S-----?SS--------------------?X--------------------------------------------------??----------------
XXXXXXXXXXXXXXXXXX----XXXXXXXX----XXXX------------XXXX----------------------------------------------------------------------------XXXXXXXXXX
XXXXXXXXXXXXXXXXXXXXXXXXXXXXXXXXXXXXXX----XXXX----XXXX------------XXXX----XXXXXXXXXXXX----XXXX----XXXXXXXXXXXX----------------XXXXXXXXXXXXXX
XXXXXXXXXXXXXXXXXXXXXXXXXXXXXXXXXXXXXX----XXXX----XXXXXXXX--------XXXX----XXXXXXXXXXXXXXXXXXXX----XXXXXXXXXXXXXXXXXXXXXXXX----XXXXXXXXXXXXXX
