--------------------------------------------------------------------------------------------------------------------------------------------
--------------------------------------------------------------------------------------------------------------------------------------------
--------------------------------------------------------------------------------------------------------------------------------------------
--------------------------------------------------------------------------------------------------------------------------------------------
-----------------------------------------------------o---------oo-------------------------------------------------o-o-o--o------------------
----------oo------o-o----o----o-------o------o-----o------oo--o------ooo-----o------------oo----------------------------o-------------------
------------o---oo---oooo---------o--------o------o---o--o---------o------------------------o----------o-o-o-----------o--------------------
------o-oo--??X----o-------oo--oo------oo--S-X--oo-?S--o----oo----o-o---o---o----oo--oo------o----o----------ooo--------??-oo---------------
-------?SX---------------------X-X--------------------S--?---------S?--?-S?X?--oo---?---oo??SX---o-oo-o---o------------------o--------------
--------------------------o--o----------------S?SS------------------------------------X-X------o-----o-?-?-XS---o-----------?---------------
---------------------------??-----------------------------------------------------------------S---------------X-----------------------------
----------XXXXXXXX----XXXX--------XXXX----XXXX----XXXX--------XXXX------------------------------------------------XXXXXXXX------------------
XXXXXXXXXXXXXXXXXXXXXXXXXX----XXXXXXXXXXXXXXXX----XXXXXXXXXXXXXXXXXXXXXXXXXXXX----XXXX----XXXX--------------------XXXXXXXX--------XXXXXXXXXX
XXXXXXXXXXXXXXXXXXXXXXXXXX----XXXXXXXXXXXXXXXXXXXXXXXXXXXXXXXXXXXXXXXXXXXXXXXX----XXXXXXXXXXXX--------XXXXXXXX----XXXXXXXXXXXX----XXXXXXXXXX
