--------------------------------------------------------------------------------------------------------------------------------------------
--------------------------------------------------------------------------------------------------------------------------------------------
--------------------------------------------------------------------------------------------------------------------------------------------
--------------------------------------------------------------------------------------------------------------------------------------------
------o------------o------------------------------------------------------------------------------------------------------------------------
-------oo---o--o--o--o-------------o----------------o-------------oo-o------------------o--oo-------o---o-----o-o----ooo--------------------
---------oo---------o---------o------o---------o-------------o-------------------------o---------o---o-------o-o--------oo------------------
---------?-o-o---o-----o--------oo-----o--o--o--o-oo-o--o-o-o----------o--------o-----XX-?o----o--oo---o--o---X?---o----?-o--o--------------
----------X?XS?S----------ooo-----------oo-o-----o--S?-o---o------X-??o--------o-o--o-----?-???-------------o--------------o----------------
------------------------oo---o-??S------------?X-X------------o-o-------o-----o-----??---------------------?--------------?-?X--------------
--------------------------?-?X------------------------X---------?-----S-?S------------------------------------------------------------------
XXXXXXXXXX--------XXXX------------XXXX------------------------------------------------XXXX--------------------XXXX----XXXX------------------
XXXXXXXXXXXXXXXXXXXXXX------------XXXX------------XXXX------------XXXX----XXXX--------XXXXXXXXXXXXXXXXXXXX----XXXXXXXXXXXX------------------
XXXXXXXXXXXXXXXXXXXXXX--------XXXXXXXX----XXXXXXXXXXXX----XXXX----XXXX----XXXX----XXXXXXXXXXXXXXXXXXXXXXXXXXXXXXXXXXXXXXXXXXXX------XXXXXXXX
