--------------------------------------------------------------------------------------------------------------------------------------------
--------------------------------------------------------------------------------------------------------------------------------------------
--------------------------------------------------------------------------------------------------------------------------------------------
--------------------------------------------------------------------------------------------------------------------------------------------
--------------------------------------o-------o--------oo------o-------------oo------------------------------o---------------o--------------
-------------------------------o---o----oo------------o--o-------o-------------o-------------------------------------------oo---------------
------o-------------o-------o-----o--o-o-------o-o---------------------o--------oo----------o--------------oo-o-o----o-o-o------------------
--------oo----o--o-o-o-------oo-oo---------o-o--XSo-o-??------------ooo-o---------------o--o-o-----oo-o--o-X??----?-----o-XX-?--------------
---------?----X?X-----oo-o?X??XS???-------o--------o-------o----------------------o------oo---o---------------??X?----o---------------------
----------ooo----------------------------------------o----o-oo--------S?------------S?-o--?------o-X---oo---------------??------------------
----------X??S----------S?------------------------??SX-------------SXS----------------?--?----X---------------------------------------------
--------------------------------------XXXX----XXXX----XXXX----XXXX--------XXXXXXXX------------------------XXXX----XXXX----XXXX--------------
XXXXXXXXXX----XXXXXXXX----XXXXXXXXXXXXXXXX----XXXX----XXXX----XXXX--------XXXXXXXX------------------------XXXXXXXXXXXX----XXXX----XXXXXXXXXX
XXXXXXXXXX----XXXXXXXX----XXXXXXXXXXXXXXXXXXXXXXXX----XXXX----XXXX----XXXXXXXXXXXXXXXX----XXXX----XXXX----XXXXXXXXXXXXXXXXXXXX----XXXXXXXXXX
