--------------------------------------------------------------------------------------------------------------------------------------------
--------------------------------------------------------------------------------------------------------------------------------------------
--------------------------------------------------------------------------------------------------------------------------------------------
--------------------------------------------------------------------------------------------------------------------------------------------
------------------------o-------------------------------------------------------------------------------------------------------------------
----------------------o----oo---o---------------------------------------------oo------------------------------------o--------o--------------
-------------------------------o-oo----------------o----------------------------o--------o-------o----------oo-------------oo---------------
---------ooo-------o-----?o------------o-----o--o-o----------o-----o-o-o---------------------o----------o-X-??------------o-----------------
-------oo---o----oo-------??X-?--XS-S-o-oo-o--------oo---o-------o--o-o--oo-o--?--o-----S-------o-ooooo----------------o--------------------
----------X---o-----oo---------------------?---o-oX?--o-----o--X-?SX??--XX----------------o-o-?S--------SX----o-o-----o--o------------------
------???X--------------------------------------S----------------------------S------------???S-----------------S?-------SX------------------
----------------------XXXX--------------------------------------------------------------------------------XXXX------------------------------
----------------------XXXXXXXXXXXXXXXX----------------------------------------XXXX----XXXX----------------XXXX----XXXX----XXXX--------------
XXXXXX----XXXX--------XXXXXXXXXXXXXXXX----XXXX----XXXX--------XXXXXXXXXXXX----XXXX----XXXX----XXXX----XXXXXXXX----XXXX----XXXX----XXXXXXXXXX
