--------------------------------------------------------------------------------------------------------------------------------------------
--------------------------------------------------------------------------------------------------------------------------------------------
--------------------------------------------------------------------------------------------------------------------------------------------
--------------------------------------------------------------------------------------------------------------------------------------------
---------o---------------------------------------o--------------------------------------o-------oo----------------------o-------------------
------------------------------oo--oo----------o-o---------o-----------------------o------o-o---o-----o----------oo----oo--------------------
-------o------o----------o-----------o------------------oo-o------------------oooo--------o--------oo---------o-----------o--o--------------
--------?S--o--------o----o---?S??-------o----SX??-o-o------oo------ooo------------oo-??????------------o---------o-o---X--o----------------
----------o----o--ooo-ooo--o-------?--ooo----o----o-o------------------oo--o-o-----------------------?-o-----o??S-----------o---------------
------------------------S----o------------o----------------------X-o-----oS??--------------------------?SS--o---------------SS--------------
-----------S?-------------???X--------------SX----??XS------------X--?--?S--------------------------------S?S-------------------------------
XXXXXXXXXX--------------------XXXX------------XXXX----XXXX----------------------------XXXXXXXXXXXX--------------------XXXX------------------
XXXXXXXXXX--------------------XXXXXXXX--------XXXX----XXXXXXXX--------------------XXXXXXXXXXXXXXXXXXXX--------XXXX----XXXX--------XXXXXXXXXX
XXXXXXXXXX----XXXXXXXXXXXX----XXXXXXXX--------XXXX----XXXXXXXXXXXX--------XXXXXXXXXXXXXXXXXXXXXXXXXXXXXXXX----XXXX----XXXXXXXXXXXXXXXXXXXXXX
