--------------------------------------------------------------------------------------------------------------------------------------------
--------------------------------------------------------------------------------------------------------------------------------------------
--------------------------------------------------------------------------------------------------------------------------------------------
--------------------------------------------------------------------------------------------------------------------------------------------
----------------------------------------------------------------------------------------oo--o-------oo---------------------oo---------------
-------o-o--------o------o--o-oo--o-o------------------o---o--oo-o-ooo------------------------------------------------o-o-o-----------------
--------o-o----o-o-ooo-o---o-o-----------------o---------o------------------------o---o---oo-----o-o---------o------o--------o--------------
---------X-o-----------S-?-X??----------o----o--o-oo---?S---o-------??o--o--o---oo-----X-?S?-?-oo------o-oo---o---o----o-o-S----------------
------------o--------S--------S-SX----o--o----o--o---------------------o--o--------------------------------oo--oo-------?-------------------
-----------SS-S?---------------------------o---?X?SS??----------------?-SS-o--oo--------------?-X-----------S----oS-------------------------
--------------------------------------------S-----------------------------X-----------------------------------????--------------------------
XXXXXXXXXX------------XXXXXXXX----XXXX----------------XXXX--------XXXX------------XXXXXXXXXXXX----XXXX--------------------XXXX--------------
XXXXXXXXXX--------XXXXXXXXXXXXXXXXXXXX----------------XXXXXXXXXXXXXXXX------------XXXXXXXXXXXX----XXXX----------------XXXXXXXX--------------
XXXXXXXXXXXXXXXXXXXXXXXXXXXXXXXXXXXXXX--------XXXXXXXXXXXXXXXXXXXXXXXXXXXX--------XXXXXXXXXXXXXXXXXXXX----XXXX----XXXXXXXXXXXX----XXXXXXXXXX
