--------------------------------------------------------------------------------------------------------------------------------------------
--------------------------------------------------------------------------------------------------------------------------------------------
--------------------------------------------------------------------------------------------------------------------------------------------
--------------------------------------------------------------------------------------------------------------------------------------------
-----------------------------------------------------------------------------------------o--------------oooo--------o-----------------------
---------------------o-ooo-----------------o------------------o-----ooo--------o-o----o-o----------o--o-----oo-------------o----------------
-------------o----ooo---------o-------------o-o--------o----------------oo------o-----------o-----o-oo----------o-o--o----o-o---------------
----------------------o--------oo----o---------o---------o-o-------??-?S??---------o--S--S------o------???-X??-o-------o-o------------------
--------ooo-------------S?o-oo---o--o-o-----?---oo--oo----o-o--X-?--------o-oo------o-----o--o?---------------o-------o---???S--------------
--------X-??X?-------------o---??X-----oo-----XSX?o---S------o-----------------------o-----?-?-----------------?----------------------------
---------------------------?X?--------------------XX??------------------------------S?------------------------------------------------------
------------------XXXX--------------------------------------------XXXXXXXX----XXXX----XXXX--------XXXXXXXXXXXX----XXXX----------------------
--------------XXXXXXXXXXXX----------------XXXX----------------XXXXXXXXXXXX----XXXX----XXXX----XXXXXXXXXXXXXXXX----XXXX----XXXX----XXXXXXXXXX
XXXXXXXXXXXXXXXXXXXXXXXXXX----XXXX--------XXXXXXXX----XXXX----XXXXXXXXXXXXXXXXXXXX----XXXXXXXXXXXXXXXXXXXXXXXXXXXXXXXXXXXXXXXXXXXXXXXXXXXXXX
