--------------------------------------------------------------------------------------------------------------------------------------------
--------------------------------------------------------------------------------------------------------------------------------------------
--------------------------------------------------------------------------------------------------------------------------------------------
--------------------------------------------------------------------------------------------------------------------------------------------
-----------o--o-------------------------------------oo-----------o------------------------------------o-------------------------------------
---------------oo------------------------------oo-------------oo------o-o-----o-o--o------o-o----o--------o--o------oo----------------------
--------o-o------o-----o----o-------------o---o--o-o-------o----o--o---o---o---o-----o-----o----o------o----o-----o------o------------------
----------?XX--S?--oo----oo--oo-------o-o----o----??XS-oo--------?--oo---So--o-------------SXS-?--------?S------o------oo----o--------------
------oo-o---------------?---------------o--S?XX??--------o-o---------------o---------o--o--------o-------?S?S-o-o----o---------------------
-------S-?--------X-------???S-------------------------------------XX?-----------------o-----------ooo--------o---------S?-?S---------------
------------------------------XX??--------------------??------------------------------------------------------SX----------------------------
----------XXXXXXXX--------------------------------XXXX--------XXXX----XXXX----XXXXXXXX----XXXXXXXX----XXXX--------XXXX------------XXXXXXXXXX
----------XXXXXXXX----XXXX----------------XXXXXXXXXXXX--------XXXX----XXXX----XXXXXXXX----XXXXXXXX----XXXXXXXX----XXXX------------XXXXXXXXXX
XXXXXXXXXXXXXXXXXXXXXXXXXXXXXX--------XXXXXXXXXXXXXXXX----XXXXXXXXXXXXXXXXXXXXXXXXXXXX----XXXXXXXX----XXXXXXXX----XXXXXXXXXXXX----XXXXXXXXXX
