--------------------------------------------------------------------------------------------------------------------------------------------
--------------------------------------------------------------------------------------------------------------------------------------------
--------------------------------------------------------------------------------------------------------------------------------------------
--------------------------------------------------------------------------------------------------------------------------------------------
-------------------o-------------o---ooo------------------------------------------o---------------oo-o------o-------------------------------
--------------------o----------o--o-----o----------------o----ooo---------------------------------------------------------o-----------------
----------o---o--o---o------o-o-o--o--------------o---------o----o---o------o------o--------oo---o----o-o--o-oo---o----o--------------------
-------o-----o---------------o?--?SX------------o----oo----o--------o--o--oo---o----------oo--------------?-?-------------------------------
--------o------------------o----------------------XX??SXS-o----X-?-S??--o-S---o----------o----o--------X?-----?X--------o-?X----------------
---------oX?SX-----------o-SX----------------?-o-o--------------------o---------------??S-??-X----------------------------------------------
------XX?X---------------?--------------------S?S?--------------------?X??------------------------------------------------------------------
------------------XXXX--------XXXXXXXXXXXX----------------------------------------XXXX------------XXXX----XXXX------------------------------
------------------XXXX--------XXXXXXXXXXXX--------XXXXXXXX----XXXXXXXX----XXXX----XXXX------------XXXXXXXXXXXXXXXXXXXX----XXXX------XXXXXXXX
XXXXXX----XXXXXXXXXXXX----XXXXXXXXXXXXXXXXXXXX----XXXXXXXXXXXXXXXXXXXX----XXXX----XXXXXXXXXXXXXXXXXXXXXXXXXXXXXXXXXXXXXXXXXXXX------XXXXXXXX
