--------------------------------------------------------------------------------------------------------------------------------------------
--------------------------------------------------------------------------------------------------------------------------------------------
--------------------------------------------------------------------------------------------------------------------------------------------
--------------------------------------------------------------------------------------------------------------------------------------------
-------------------------------------o---o-------------------o------o--------------------------------------o-o-o----------------------------
--------------o--o----------------o-o---o----------o-o------o--------o--------------------oo-----------oo---o-o-o---------------------------
------o--------------------oo-oo------oo----------o--------o--o---------o--o------o-----oo-----oo--------o-------o--------o-----------------
--------o--o------o-------o-----o-------------o-----------------ooXX--oo------o--o---------------o-------?X-????X?-o-o-----oo---------------
-------o-o---------ooo---o---o---o---------?S----o-X??-o------?-S--------oS----o---o---o---?S?----o--o-----------------o-o---o--------------
-------XX-o-o-------------?S-??-S?-----------------------o------------S--S-----------?---?---------oo---------------------?--?--------------
-----------??---------------------------------??------X-----------------------------------------------------------------X-------------------
----------------------------------XXXXXXXX----------------XXXX----XXXX--------------------------------XXXXXXXXXXXX--------------------------
--------------XXXX----------------XXXXXXXXXXXX----XXXX----XXXXXXXXXXXX----XXXX------------XXXXXXXX----XXXXXXXXXXXXXXXX----------------------
XXXXXXXXXX----XXXXXXXX----XXXXXXXXXXXXXXXXXXXX----XXXX----XXXXXXXXXXXXXXXXXXXX----XXXXXXXXXXXXXXXX----XXXXXXXXXXXXXXXX----XXXXXXXX--XXXXXXXX
