--------------------------------------------------------------------------------------------------------------------------------------------
--------------------------------------------------------------------------------------------------------------------------------------------
--------------------------------------------------------------------------------------------------------------------------------------------
--------------------------------------------------------------------------------------------------------------------------------------------
------------------------------o----------------------o----------o-o--o----------------------------------------------------------------------
---------------------------------o---------------o-o---------------o-------------------o-------------------------------o--------------------
--------------o----------o-o---o---------------oo-o-o-----oooo-------------oo------------o------------------------o--oo--o------------------
------------o--ooo--o--------o--?Sooo-o-oooo------SSSS--oo-------?--??-o-o---o---o----o-------------o-------o----o------?-o--o--------------
-------oooo-------o---------------?----o--------X?--------------------o---o---o----o--??S?-o-oo----o-o---?--SXooo----------o----------------
------?X??-o-------o-o--?SS?X?------------------------?--X-----------------?---oo----S----o-------------------X-?-S-------------------------
----------?XS--------------------------------S------------------------SXXS----------------SSX?----------------------------?-?S--------------
------------------------------XXXX----------------XXXX----XXXXXXXXXXXX------------------------------------------------XXXX--------XXXXXXXXXX
------------------------------XXXXXXXX--------XXXXXXXX----XXXXXXXXXXXX----------------XXXX------------XXXXXXXX--------XXXX--------XXXXXXXXXX
XXXXXXXXXX----XXXX----XXXXXXXXXXXXXXXXXXXX----XXXXXXXXXXXXXXXXXXXXXXXX----XXXX----XXXXXXXX----XXXX----XXXXXXXXXXXXXXXXXXXX--------XXXXXXXXXX
