--------------------------------------------------------------------------------------------------------------------------------------------
--------------------------------------------------------------------------------------------------------------------------------------------
--------------------------------------------------------------------------------------------------------------------------------------------
--------------------------------------------------------------------------------------------------------------------------------------------
--------------------------o--o----------o--------------------------------------o------------------o-o---------------------------------------
--------oo-----o--------o---o------oo-oo--------oo---------------------------oo-o----------ooo----------------------------------------------
-------o---oo---------o-------o--o---------o-o-----------------oo---------o------o--------o--------o-o---o-----------------oo---------------
--------XXo---o-----o----o-----oo-----------------oo-o--o--------o--o-o-o-----------------?S-S-o-------oo-o--o----oo-o----o-----------------
----------X-?X-S-S-------------?-??--?----o------?--o-o--oo---o----o--------SX---------o-o-------o----------o-oo-------o-o-S-?--------------
------------------oo-o----------------------------????-----oo--?S?---o------------------o---------------S?-----S?-S-------------------------
------------------------------------------------------SS----------S-XXSSXX---------------?----------------?--X----------?X------------------
XXXXXXXXXX----------------XXXX--------XXXX------------------------------------XXXX--------XXXX----XXXX--------------------------------------
XXXXXXXXXXXXXXXXXX----XXXXXXXXXXXXXXXXXXXX----XXXX------------------------XXXXXXXX--------XXXX----XXXX--------------------XXXX----XXXXXXXXXX
XXXXXXXXXXXXXXXXXX----XXXXXXXXXXXXXXXXXXXXXXXXXXXXXXXX--------XXXX--------XXXXXXXXXXXX----XXXXXXXXXXXXXXXX----XXXXXXXX----XXXXXXXXXXXXXXXXXX
