--------------------------------------------------------------------------------------------------------------------------------------------
--------------------------------------------------------------------------------------------------------------------------------------------
--------------------------------------------------------------------------------------------------------------------------------------------
--------------------------------------------------------------------------------------------------------------------------------------------
-------------------o--------------------ooo---------------------------------o-----------------------------------------o-oo------------------
------------o-o-----o-------------o-o-o----o---------------oo-------------oo-----------o----------------------------------------------------
-----------o----oo---o-o------o-o----o-o----oo---------------o-o------o--o------o-----o-o-----------------oo-o------oo-o----o---------------
---------o---o?--------------o---o-----------Sooo--o-o---oo-----ooo-oo--------o--o---o---o--o-o----o--------o-oo-o------??---o--------------
-----------SS?--------o---o-o--o---S------------------------------------o------o--o---S?SSo-------o---o--o--------?XS-----------------------
--------------------------?SX-X?-?------------XX?-o-o-o---------------S?------------------------o---oo-oo-?-S?--o-----------XS--------------
------XXS-------------------------------------------XS-------------SX---------------??----?SX??---------------????--------------------------
--------------XXXXXXXX----------------XXXXXXXX----------------------------XXXX----------------------------------------XXXX------------------
XXXXXX----XXXXXXXXXXXX------------XXXXXXXXXXXX------------XXXX------------XXXX--------XXXX------------------------XXXXXXXX--------XXXXXXXXXX
XXXXXX----XXXXXXXXXXXXXXXXXXXXXXXXXXXXXXXXXXXXXXXX--------XXXXXXXX----XXXXXXXXXXXX----XXXX----------------XXXX----XXXXXXXXXXXXXXXXXXXXXXXXXX
