--------------------------------------------------------------------------------------------------------------------------------------------
--------------------------------------------------------------------------------------------------------------------------------------------
--------------------------------------------------------------------------------------------------------------------------------------------
--------------------------------------------------------------------------------------------------------------------------------------------
---------------------oo--o---------------------------o------------------------------o-----------o-----------------o--o----------------------
---------------o-o--o---o-------------------------oo-------------o------o----o-----------------o-----------o-o-o-------ooo--o---------------
--------o-o--------o--------------o------oo-------------------o-------oo----o--o--o--o-------------------o------------o---------------------
-------o-o-------------S----o------o--o----o-----oXSS?---ooooo-?-?----?SS--?--------XX-o-o----S---oo----------o--o--------------------------
-----------oo-----------------o---?-----o----o--o-----oo-------------o----------o----------o--------oo---------?SX------S-?-??--------------
------?-?-X--?---------------o-oo---------------SX------o---------X?-X-----------?------o-o-------------------------------------------------
--------------------------X-SS-X-S----------------------------------------------------XS-?S?X?----------------------------------------------
------------------XXXXXXXX------------------------XXXX--------XXXX----XXXXXXXX----XXXX--------XXXX----XXXXXXXX----XXXX----------------------
--------------XXXXXXXXXXXX--------XXXX------------XXXX--------XXXX----XXXXXXXX----XXXX--------XXXX----XXXXXXXXXXXXXXXXXXXXXXXXXXXX--XXXXXXXX
XXXXXXXXXXXXXXXXXXXXXXXXXX--------XXXXXXXXXXXXXXXXXXXX--------XXXXXXXXXXXXXXXXXXXXXXXX--------XXXXXXXXXXXXXXXXXXXXXXXXXXXXXXXXXXXX--XXXXXXXX
