--------------------------------------------------------------------------------------------------------------------------------------------
--------------------------------------------------------------------------------------------------------------------------------------------
--------------------------------------------------------------------------------------------------------------------------------------------
--------------------------------------------------------------------------------------------------------------------------------------------
--------------------------oo----------------------------oo-------------o------------------------o------------------------o------------------
---------------------------------------o-o-------------o--------------o--oo-----------o----------o----------------oo--o---------------------
-------------------o--------oo----------o-----------------o-o-----------------oo--oo----o-o--oo--------------o-------o-o--------------------
------------------o-o-o------X--------o---o----o-----o-S------------oo??X----o---o---o---o----------o------------o------X?------------------
------o-oo-------------o------o-o----o-S----o-------o------o-o-o--oo------------------S-SX-oo-----oo-o------o-ooo----------oo---------------
------?S-So---o-o--------------o---o------------oooo------X------X-------------------?----X-?-------------??-?------------o-----------------
-----------???X---------------X??X?-XX--------X-X-????------------SSS------------------------------------------?-?--------?X-?--------------
--------------------------XXXX------------------------XXXX------------XXXX--------------------XXXX----------------XXXXXXXX------------------
--------------------------XXXX--------XXXX------------XXXX------------XXXXXXXX--------XXXX----XXXX----------------XXXXXXXX----XXXX--XXXXXXXX
XXXXXXXXXX--------XXXX----XXXX--------XXXXXXXX--------XXXXXXXXXXXX----XXXXXXXXXXXXXXXXXXXXXXXXXXXXXXXX----XXXX----XXXXXXXX----XXXX--XXXXXXXX
