--------------------------------------------------------------------------------------------------------------------------------------------
--------------------------------------------------------------------------------------------------------------------------------------------
--------------------------------------------------------------------------------------------------------------------------------------------
--------------------------------------------------------------------------------------------------------------------------------------------
-------------o--------------o-----------------oo-o--oo------------------------------------o--o---------------o---------ooo------------------
--------------------o-----oo-o---------------------o-------------------oo------------------o------o-o------o----------o---------------------
------o-o-oo------oo--oo------------------------o-o-------ooo-----------------o---o----------------o-o------------o--o----------------------
----------?-X-o------o--XSSX?So------o---------?-XXX?X--o----o--------o--o------o---o--o-o?--Soo-o------?-S?X?-oo---o---S?------------------
---------o---------------------o----o-oo-----o--------oo-o-------?-o--SS-----o-o-----X------------------------o-----?-----------------------
-------SXS-----o------------------S-X---ooo-o-----------------------oo-----oo---------XXX?--------------------???S--------oo----------------
------------------------------?-SS---------------------------------X??----S-------------------X---------------------------S-X?--------------
----------XXXX--------XXXXXXXX----------------XXXXXXXX------------------------------------XXXX----XXXXXXXXXXXX--------XXXX------------------
----------XXXX----XXXXXXXXXXXX----------------XXXXXXXX----XXXXXXXX----XXXX--------XXXX----XXXX----XXXXXXXXXXXX----XXXXXXXX----XXXX----------
XXXXXXXXXXXXXX----XXXXXXXXXXXX----XXXX--------XXXXXXXX----XXXXXXXX----XXXX----XXXXXXXXXXXXXXXX----XXXXXXXXXXXXXXXXXXXXXXXX----XXXXXXXXXXXXXX
