--------------------------------------------------------------------------------------------------------------------------------------------
--------------------------------------------------------------------------------------------------------------------------------------------
--------------------------------------------------------------------------------------------------------------------------------------------
--------------------------------------------------------------------------------------------------------------------------------------------
------------------oo-o----o-------------------o--o--------------oo---oo--o------------------------------------------------------------------
--------o----o------o-o-----o-------o--o---o-o--o--------------o------------------ooo-oooo--------o-o-oo------------------------------------
------oo--o-o----o------oo---o-------o--------------------o---------o----------------------ooo-------o--------------------o-----------------
---------o-o-----------X-??X?-----------oo----SSX?o--ooo---o----X-?-???X-X-------o---S----?SSS-o---o------o-oo-----o---ooo-o-o--------------
-------?-XX???-------------------o-----------?-----o--------oo-----------------o------??SS----o------?---X----o-o---ooo-----o---------------
------------------------------o-------------------------------------------------o----------------o--------???-X?SS------X?X-X---------------
-------------------------------?S?----------------?-------------------------------------------X---------------------------------------------
--------------XXXXXXXXXXXXXXXX----------------XXXX------------XXXXXXXXXXXX--------XXXX----XXXX--------------------------------XXXX----------
XXXXXXXXXXXXXXXXXXXXXXXXXXXXXX----XXXXXXXXXXXXXXXX----XXXX----XXXXXXXXXXXXXXXX----XXXXXXXXXXXX----XXXXXXXX--------------------XXXX----------
XXXXXXXXXXXXXXXXXXXXXXXXXXXXXX----XXXXXXXXXXXXXXXX----XXXXXXXXXXXXXXXXXXXXXXXX----XXXXXXXXXXXX----XXXXXXXXXXXXXXXXXXXXXXXXXXXXXXXXXXXXXXXXXX
