--------------------------------------------------------------------------------------------------------------------------------------------
--------------------------------------------------------------------------------------------------------------------------------------------
--------------------------------------------------------------------------------------------------------------------------------------------
--------------------------------------------------------------------------------------------------------------------------------------------
----------------------------------o--------------o---------------------o----------o---------------------------------------------------------
------------------------------o-o-----ooo-------o-oo-------------------------------------------------------------------o--o--o--------------
-----------oo--o---o---o--oo-------o-----o----------o------------o---o----o----------------------------ooo------------o-----o---------------
-------oo-----o-oo---o--X----o-o--?????---o-----??--------oo----o-o---SS-----o-o-o---X--oo-o-----o-ooo------o--oo--------o-o----------------
----------o--oS-----o------?X?S?S?-----------o----???--o---------?---------------------???---o---------???o--oo------o---X?-??--------------
---------oX??S-----------------------------o----------------oo----S?----------------------o-o-------------X?S-----X-------------------------
---------S---------------------------------------------?----------------------------------SSXX?---------------X--?--------------------------
----------------------XXXX--------XXXXXXXX----XXXX--------------------XXXX--------XXXX--------------------------------------------XXXXXXXXXX
--------------XXXX----XXXXXXXXXXXXXXXXXXXX----XXXXXXXX--------XXXX----XXXX--------XXXXXXXX------------XXXX------------XXXXXXXX----XXXXXXXXXX
XXXXXX----XXXXXXXXXXXXXXXXXXXXXXXXXXXXXXXX----XXXXXXXX--------XXXXXXXXXXXXXXXX----XXXXXXXX--------XXXXXXXXXXXX----XXXXXXXXXXXX----XXXXXXXXXX
