--------------------------------------------------------------------------------------------------------------------------------------------
--------------------------------------------------------------------------------------------------------------------------------------------
--------------------------------------------------------------------------------------------------------------------------------------------
--------------------------------------------------------------------------------------------------------------------------------------------
-------------------------o-----------------------o---------------o-------------------------o------------------------------------------------
---------o-----------------------------------------------------o----------------------------oo-----------o-o---o--oo-----o---o--------------
--------o----------o---------o------------o---o---o--o--o-----------------o--------o------o-----o------------o------------o-----------------
-------o------o--oo------------o-oo----oo-----?XS--o---o-o--o-SS---o-----o-------o----o---?-??o--o-----o----o-o-oo---oooo-------------------
------??-?oo-o--o---o---------o----o----------------o-o---o----------o--o-X-X-ooo------------------o-o--???XS------------S?-?X--------------
------------o--?-----------?-S??S?--o-------S?----??------------------oo-----------S-----o----S---o-o---------------------------------------
----------?-SS--------------------S-------------------------------?SSSS??S------------?X?X--------------------------------------------------
----------------------XXXX--------------------XXXX------------XXXX------------------------XXXX------------------------------------XXXXXXXXXX
XXXXXXXXXX------------XXXX------------XXXX----XXXX------------XXXX--------XXXX------------XXXX--------XXXXXXXXXXXXXXXXXXXXXXXXXXXXXXXXXXXXXX
XXXXXXXXXX----XXXXXXXXXXXXXXXXXXXX----XXXXXXXXXXXXXXXXXXXXXXXXXXXX--------XXXXXXXXXXXX----XXXXXXXX----XXXXXXXXXXXXXXXXXXXXXXXXXXXXXXXXXXXXXX
