--------------------------------------------------------------------------------------------------------------------------------------------
--------------------------------------------------------------------------------------------------------------------------------------------
--------------------------------------------------------------------------------------------------------------------------------------------
--------------------------------------------------------------------------------------------------------------------------------------------
----------------------------------o-o-o--o----------o--------------------------------------------o------------------------------------------
--------o---------------------------------------o-o--o----o-o----------------------------------o-------------------o------------------------
---------o-----------o-oo-o------------oo-----oo-----------o-oo-o--oo-o-------------------o---o---oo--o--------------o-----o----------------
-----------o-o-o--o-o-o------o----?S-?-----o-----oXS---o-------------o---ooo---ooo------oo--o-------o--o----------o---oooo--o---------------
------X??Xo---o----o-------oo-o--o-----------o?--S----S------------?XS-o-----o------o--??S-o----------------oooo--S-----X?--?S--------------
-----------??---oo-------?-S?-----------------------------------------?-S?-S------?-SS----XX?S------------?X-?------------------------------
------------------------------?-XX----------------------------------------------------------------------------?-??--------------------------
----------------------------------XXXXXXXX--------XXXX----XXXX--------------------------------XXXX----------------------------XXXX----------
XXXXXXXXXX------------------------XXXXXXXX----XXXXXXXXXXXXXXXX----XXXX----------------XXXX----XXXXXXXXXXXX--------XXXXXXXXXXXXXXXXXXXXXXXXXX
XXXXXXXXXXXXXX----XXXXXXXXXXXX----XXXXXXXX----XXXXXXXXXXXXXXXXXXXXXXXXXXXXXXXX----XXXXXXXXXXXXXXXXXXXXXXXXXXXX----XXXXXXXXXXXXXXXXXXXXXXXXXX
