--------------------------------------------------------------------------------------------------------------------------------------------
--------------------------------------------------------------------------------------------------------------------------------------------
--------------------------------------------------------------------------------------------------------------------------------------------
--------------------------------------------------------------------------------------------------------------------------------------------
----------o----------------------------o-----o-----o--------------oo-o---------------------------------oo------o---o---o---oo---------------
--------------------o---------------------oo-------------o-----------------o---o----------o--oo--o----o-------------o----o---o--------------
-------o-----------o-----o---o----------oo--o---------o-o-----o-o---o--------o------oo---------oo---o--------oo---o---o-o-------------------
---------oSXXSX-----------o-o--o----o-------XX---oS???-------o-o---?-So----------o-----o-o-oo-----oo-----X-----X-?-------S?-SX--------------
--------o-------------oo------------------------o-----?S-?--o-----------o-----------X------?---------o----ooo-------------------------------
-------?----------------?-?SXXo---oo-o--------oo-----------o----------------------------------------------S???------------------------------
------------------------------X?XS--------------S?--------------------?XX?------------S--S--------------------------------------------------
----------XXXXXXXX--------------------XXXXXXXX----XXXX------------XXXX--------------------------------XXXX----XXXXXXXXXXXXXXXX--------------
----------XXXXXXXXXXXX----------------XXXXXXXX----XXXXXXXX--------XXXX----XXXXXXXXXXXX----XXXXXXXX----XXXX----XXXXXXXXXXXXXXXX----XXXXXXXXXX
XXXXXXXXXXXXXXXXXXXXXXXXXXXXXX--------XXXXXXXX----XXXXXXXX----XXXXXXXX----XXXXXXXXXXXX----XXXXXXXXXXXXXXXXXXXXXXXXXXXXXXXXXXXX----XXXXXXXXXX
