--------------------------------------------------------------------------------------------------------------------------------------------
--------------------------------------------------------------------------------------------------------------------------------------------
--------------------------------------------------------------------------------------------------------------------------------------------
--------------------------------------------------------------------------------------------------------------------------------------------
--------------o---------------------o----------------o------oo-----------------------oo-o--o------------------------------------------------
----------oo-o--o-o-----------o---o---o-------o--o-o-------o---------o------------o-o------------o-----------------o------------------------
-----------------o-o--------oo-o---o-o--o---------o-----o-------------oo-o---------------oo-----------------oo------------------------------
-------o-o--o-X?----o------------oSX---o-oo----o--??SX--------o--o--o---o---o--ooo------XX-?S?------oo-----o--o-------o---------------------
----------?X?------------o--S-X??X----------o-S???----X-X-------o---X?-----o-o--------------------o---------------S----------o--------------
------o-o-------------o-----------------------------------------------?-------o-------------------------o-X??S--o--------o--o---------------
------???X-----------------------------------S----------------------------??-----------------------------S------?X------X??-?X--------------
--------------XXXX----------------XXXX------------XXXX----XXXX--------------------XXXXXXXXXXXX----------------------------------------------
XXXXXX----XXXXXXXXXXXX----XXXXXXXXXXXXXXXX----XXXXXXXXXXXXXXXX----XXXX------------XXXXXXXXXXXXXXXX----------------XXXX--------------XXXXXXXX
XXXXXX----XXXXXXXXXXXX----XXXXXXXXXXXXXXXX----XXXXXXXXXXXXXXXXXXXXXXXXXXXX--------XXXXXXXXXXXXXXXX--------XXXX----XXXX--------------XXXXXXXX
