--------------------------------------------------------------------------------------------------------------------------------------------
--------------------------------------------------------------------------------------------------------------------------------------------
--------------------------------------------------------------------------------------------------------------------------------------------
--------------------------------------------------------------------------------------------------------------------------------------------
--------------------------o-oo--------o-------------------------o---o-----------------------------------------o------o----------------------
-------oo--------------------------------------o--o---------o----o---ooo-o----------------------------o--o--o-------------------------------
----------o-----o----------------------ooooo--o--o--------oo---o--o---------------o----------------o---o-------o-o--o------oo---------------
---------o-o---o---oo-o---S???-o--------?X---o-----o-o-o-----o-----?S?------------------------------o---?Soo-o?XS-----o---o--o--------------
------??XXX?------o--o--------o--o--o-----S-?S?-?X?-X?----------------?S??----o--o-----ooo-oo-----o--------S-S---------oooXXS---------------
-----------------------o------X--S--------------------o-o-------------------o--o------X?SXo---o-o-------------------------------------------
------------------------?S-----------------------------XS---------------------------------??-S??--------------------------------------------
--------------------------XXXX--------XXXX--------------------XXXXXXXX--------------------------------XXXX----XXXXXXXX--------XXXXXXXXXXXXXX
XXXXXXXXXXXXXXXXXX--------XXXX--------XXXXXXXXXXXXXXXX----XXXXXXXXXXXXXXXX----------------------------XXXXXXXXXXXXXXXX----XXXXXXXXXXXXXXXXXX
XXXXXXXXXXXXXXXXXXXXXX----XXXXXXXX----XXXXXXXXXXXXXXXX----XXXXXXXXXXXXXXXX--------XXXXXXXX--------XXXXXXXXXXXXXXXXXXXXXXXXXXXXXXXXXXXXXXXXXX
