--------------------------------------------------------------------------------------------------------------------------------------------
--------------------------------------------------------------------------------------------------------------------------------------------
--------------------------------------------------------------------------------------------------------------------------------------------
--------------------------------------------------------------------------------------------------------------------------------------------
--------oo----o-ooo-oo--------------------------------------------------------oo--------oo--------------------------------------------------
---------------o------------o--o-oo-o---------------------o---------------------oo----oo--o-o--------------o-o-------------oo---------------
-------o-----------o----------o----o------o-o-----o---------o-------o----------------------o---------o---------o----------------------------
-------S?S----S-------ooo----o------?----o---o--o------------oo---oo-o----o------X---o?X?----ooo---oo--o--S?X?o------o----------------------
----------oo---------------???S?S----------------o?SX-------S--oo-----o--o-ooo------------S?-X----o---o-o-----------------------------------
----------X-?X------------------------o-o------o-----------------oX?-?-o------------?X----------oo------------X?-X-----o-o------------------
-------------------------?---------------------??X------------?S-X----??S------------------------------------------------?------------------
XXXXXXXXXX----XXXXXXXX------------XXXX----------------------------------------XXXX----XXXX----------------XXXX--------------------XXXXXXXXXX
XXXXXXXXXX----XXXXXXXX----XXXXXXXXXXXX----XXXX----XXXXXXXXXXXX----------------XXXX----XXXXXXXX------------XXXX------------XXXXXXXXXXXXXXXXXX
XXXXXXXXXXXXXXXXXXXXXX----XXXXXXXXXXXX----XXXX----XXXXXXXXXXXX----XXXX----XXXXXXXXXXXXXXXXXXXX----XXXXXXXXXXXXXXXXXXXX----XXXXXXXXXXXXXXXXXX
