--------------------------------------------------------------------------------------------------------------------------------------------
--------------------------------------------------------------------------------------------------------------------------------------------
--------------------------------------------------------------------------------------------------------------------------------------------
--------------------------------------------------------------------------------------------------------------------------------------------
---------------------o-----------------------------------------------o-o----------o---oo------------o--------------o------------------------
------------------ooo------------------o--------------------o-o--o----o------------o---------------o----------------------------------------
-------------o--------------------------o----o------------o--o-o--o-o---o-o---------o----o-----------o-oo------o-----oo-ooo-o---------------
-------o----o---oo-----------------------oo-----o---o--o-o------?-?S---X?--oo-o----?-?????-------------------oo---?-X-----?-?---------------
------o---o-----------o---o---o-------------o----ooo----o----------------------ooo--------oo--?-------o---oo--------------------------------
--------ooX------------o----oo---o-?S---------o-------------------------------------------?XX-------------?X?XX??-------S-------------------
---------?----??S----------??SXX-S-------------S-S?SS-??------------------------------------------------------------------------------------
------------------XXXX------------------------------------XXXXXXXXXXXXXXXX--------XXXXXXXX--------XXXX------------XXXX----XXXX------XXXXXXXX
------------------XXXX----------------XXXX----------------XXXXXXXXXXXXXXXXXXXX----XXXXXXXX----XXXXXXXX------------XXXX----XXXX------XXXXXXXX
XXXXXX----XXXX----XXXX------------XXXXXXXXXXXX------------XXXXXXXXXXXXXXXXXXXX----XXXXXXXXXXXXXXXXXXXXXXXXXXXXXXXXXXXXXXXXXXXX------XXXXXXXX
