--------------------------------------------------------------------------------------------------------------------------------------------
--------------------------------------------------------------------------------------------------------------------------------------------
--------------------------------------------------------------------------------------------------------------------------------------------
--------------------------------------------------------------------------------------------------------------------------------------------
---------------------------------------o-----------o----------------------------------------oo----------------------------------------------
-------------------ooooo-------oo----------o--------oo-------------oo----------oo------o-o-----------------------------oo-oo----------------
------------------o-----------o------o--ooo---o-o-o---------------o-----------o--o--------oo--------------------------------o---------------
-----------------o------oo---------------------o-o?X??----ooo------------o-ooo------o-S?X---------oo--o-----oo-------o----S-SS--------------
--------------oo----------o-o-???S?-??--------?-?S-------o---o----?-?--oo------------------------o------ooo---oo---o-----?------------------
-------o-oo--o-------------o-o-------------------------------?---o----o------------------------o----oo????-S??----X-------------------------
------?SS??X??------------?-X?----------------------------------??----SS?-----------S?------------------------?XXX--------------------------
------------------XXXX----------------XXXXXXXX----XXXX--------------------------------XXXXXXXX----------------------------XXXXXXXX----------
------------------XXXXXXXX----XXXXXXXXXXXXXXXXXXXXXXXX------------XXXX--------XXXX----XXXXXXXX------------------------XXXXXXXXXXXXXXXXXXXXXX
XXXXXX--------XXXXXXXXXXXX----XXXXXXXXXXXXXXXXXXXXXXXXXXXXXXXX----XXXX----XXXXXXXX----XXXXXXXX--------XXXXXXXX----XXXXXXXXXXXXXXXXXXXXXXXXXX
