--------------------------------------------------------------------------------------------------------------------------------------------
--------------------------------------------------------------------------------------------------------------------------------------------
--------------------------------------------------------------------------------------------------------------------------------------------
--------------------------------------------------------------------------------------------------------------------------------------------
-------------o------------------------o------------------------o------------------o-----o---------------------------------------------------
---------o--o-----oo-o-------o-------o-o-------------------------oo-----------------oo-o-oo-------------------------------------------------
----------o-------------------o-----o----o------o-----o-------------oo----------------------o--------------o-oo----o------------------------
-------o--X??---oo--o-o-o-o-o---oo------------oo-------o-o--oo-S-?-o--o---------o-------SX---o--------------o--o----o-oooo---o--------------
--------S?----X----------o??SS-o----------ooo-S--?-oo-----o-------?-X---------------------XS?S--o--o-o---o------o-o--o----------------------
-----------------------?X-----X?-------------o-------o-----o--------------?-?--o------------------o-o-----??--?-?---------?S----------------
--------------------------------------------------S?SX-------?---------?XX---------------------------?S-SS----------------------------------
----------XXXX------------------------XXXX--------------------XXXX----------------XXXXXXXX------------------------------------XXXXXXXXXXXXXX
XXXXXXXXXXXXXXXXXXXXXX----XXXX----XXXXXXXX----XXXX----XXXX----XXXXXXXX------------XXXXXXXXXXXX------------------------XXXX----XXXXXXXXXXXXXX
XXXXXXXXXXXXXXXXXXXXXXXXXXXXXXXXXXXXXXXXXX----XXXX----XXXX----XXXXXXXX----XXXX----XXXXXXXXXXXX------------XXXXXXXXXXXXXXXXXXXXXXXXXXXXXXXXXX
