--------------------------------------------------------------------------------------------------------------------------------------------
--------------------------------------------------------------------------------------------------------------------------------------------
--------------------------------------------------------------------------------------------------------------------------------------------
--------------------------------------------------------------------------------------------------------------------------------------------
-------oo-------------------oo----------------------------o-o---------o-------------------------------------oo------------------------------
---------o----o-----o-o----o----------------------o--------o-o-ooo-------o---------------------------------o------------o-------------------
-----------------ooo-o-o-----------o--o---ooo------ooo--oo----o-----oo-o--------o-o---o-o----------o----o--------------o--------------------
------------o--o--?-----o-??-?---oo--o---o--??------------?-----X?----?XS---o-oo-o-----o-------o--o-o------??X-------------o----------------
-------------oX-XX------S?-----o-------oo------o--?--X------------X?X?-----o---------o-SS?--o---o----o--------oo--S-----?So-o---------------
----------oo------------------o-o---------------oo------S----------------------------S----o-------------------??S---------------------------
----------X?-?----------------S?S?------------?-S?-----------------------------------------?-??---------------------------X?SX--------------
XXXXXXXXXX--------XXXX----XXXX------------XXXX------------XXXXXXXX----XXXX--------------------------------XXXX------------------------------
XXXXXXXXXX----XXXXXXXXXXXXXXXX------------XXXX----XXXX----XXXXXXXXXXXXXXXX------------XXXX------------XXXXXXXX----XXXXXXXX----XXXX--XXXXXXXX
XXXXXXXXXX----XXXXXXXXXXXXXXXX----XXXXXXXXXXXX----XXXXXXXXXXXXXXXXXXXXXXXX----XXXXXXXXXXXX--------XXXXXXXXXXXXXXXXXXXXXXXX----XXXX--XXXXXXXX
