--------------------------------------------------------------------------------------------------------------------------------------------
--------------------------------------------------------------------------------------------------------------------------------------------
--------------------------------------------------------------------------------------------------------------------------------------------
--------------------------------------------------------------------------------------------------------------------------------------------
-----------------------oo------------------------------o----------------------------------------------------------------o----o--------------
-------o-------------o---------------o-oo-----------------o---------------o------------ooo--o-----------o-----o-------oo--oo----------------
--------oo--------ooo-----------------o--oo-----------o-oo-ooo--oo-ooooo-o---o------o-o---o--------------o-----o---------o--o---------------
--------------o--o------XX--ooooo---o------o--oo--o--o??--------------S?-?SX?-----oo-o-----?X--------ooo--oo------------?X?X?X--------------
-------S??o---------------------------------o------oo------------XX?S?--------o--o--S-?-SS----o--oo----??---oo?----o------------------------
-----------o-o------------o---------------------oo-----------------------------oo---------------o--oo------X?-------------------------------
----------??SXS-----------S--XS?-X-------------S-SSXS---------------------------------------------------------------------------------------
----------------------XXXX------------XXXX------------XXXXXXXX--------XXXXXXXX------------XXXX------------------------XXXXXXXX--------------
XXXXXXXXXX--------XXXXXXXX--------XXXXXXXX------------XXXXXXXXXXXXXXXXXXXXXXXX----XXXXXXXXXXXX--------XXXX----XXXX----XXXXXXXX----XXXXXXXXXX
XXXXXXXXXX--------XXXXXXXX--------XXXXXXXXXXXX--------XXXXXXXXXXXXXXXXXXXXXXXX----XXXXXXXXXXXX--------XXXXXXXXXXXXXXXXXXXXXXXX----XXXXXXXXXX
