--------------------------------------------------------------------------------------------------------------------------------------------
--------------------------------------------------------------------------------------------------------------------------------------------
--------------------------------------------------------------------------------------------------------------------------------------------
--------------------------------------------------------------------------------------------------------------------------------------------
----------------------------------------------ooo------------o-----o----o---------------------------o------o--------------------------------
----------------------o---oo--------oo-------------o-------o---------oo----o--------------o-------oo-o----o-----------oo-o------------------
-------------------oo---o----o-o---o--------o----o--o-o---o-o----------o-oo----ooo---------o----------------oo-----oo---o-------------------
--------o---o----------o----o-o----S----o----o---------oo-----oo--S?-X?X?X---oo------o--o----o-------------?-X-o----------o-o---------------
------o---X--S-----------X-S-S--o-----oo----------??-S---o-----X-X--------?--------------o??S----------o-o----o-ooS-----??-o-o--------------
---------o----?---------------?X?-----------------------------------------------------SXSS----SS--------------------------S--S--------------
------SX-S--------------------------------------------------------------------------??-------------------------??S--------------------------
------------------XXXX------------XXXX--------XXXX--------XXXX----XXXXXXXX------------------------XXXX----XXXX----------------XXXX----------
XXXXXX----XXXX----XXXXXXXXXXXX----XXXX--------XXXXXXXX----XXXXXXXXXXXXXXXXXXXX------------XXXX----XXXX----XXXX----XXXXXXXX----XXXXXXXXXXXXXX
XXXXXX----XXXXXXXXXXXXXXXXXXXXXXXXXXXX----XXXXXXXXXXXXXXXXXXXXXXXXXXXXXXXXXXXXXXXX----XXXXXXXXXXXXXXXX----XXXX----XXXXXXXXXXXXXXXXXXXXXXXXXX
