--------------------------------------------------------------------------------------------------------------------------------------------
--------------------------------------------------------------------------------------------------------------------------------------------
--------------------------------------------------------------------------------------------------------------------------------------------
--------------------------------------------------------------------------------------------------------------------------------------------
------------------------------------------------------------------------------------------o-------------------------------------------------
------------------------------------------oo-------o-----------------o----------------o--o-o-----------oo-------------------o---------------
-------------------o--------------------------o-oo--o-------oo----o-------------oo-----o-----o----o-o-------oo--oo-----------o--------------
-------oo-----o-----o------o-o---o?---o-----oo-------------o----oo--o-o------o-o--o-------S-?-o-o-----------------o-------?S-S--------------
---------oo-oo-oo-o-----S?X-?S-oo------o-o---X???SX???---o---?----S-XX--------o------oXX??-----o-o-o-o---?---?oo-------o-o------------------
-----------o-----o------------o----------------------------------------oo--o---------?-------------------------X?X---o--X?------------------
--------?X-??-----------------??S------------------------------S-?-----SX------------------------------------------XS-----------------------
----------------------------------XXXX----------------------------------------------------XXXX----------------------------XXXX--------------
----------------------XXXXXXXX----XXXX----XXXXXXXXXXXX----XXXX----XXXX----------------XXXXXXXX--------XXXXXXXX------------XXXX--------------
XXXXXX------------XXXXXXXXXXXX----XXXXXXXXXXXXXXXXXXXXXXXXXXXX----XXXX--------XXXXXXXXXXXXXXXX----XXXXXXXXXXXXXXXX----XXXXXXXXXXXXXXXXXXXXXX
