--------------------------------------------------------------------------------------------------------------------------------------------
--------------------------------------------------------------------------------------------------------------------------------------------
--------------------------------------------------------------------------------------------------------------------------------------------
--------------------------------------------------------------------------------------------------------------------------------------------
----------o---o----------------------------------o---o---------------------------------o-----------------------------o--oo------------------
---------o-o---oo----------o-o--------ooo-----o-o-o-o-------o-----------------ooo---------------------------o---------o---------------------
--------o----------o------o-------o----------------o----o-o---------o-o----o-----o------oo-------------oo----o----oo---o--------------------
----------?-?X------o---o-SSXS-o-o--oo---o------?-S?--o----o-------o---o-o---o?----o---S?S----oo----------o------o???---SX---o--------------
------S-SS--------o--o--------o-o------------------------------------oX???------------------o-----o------o--?-o-------------o---------------
-------------------------X-----------------------------S------o-oo-S??----?XS--------------o-o---o-ooo---?-----o----------o-----------------
------------------------------?S??---------X----------------------------------------------?--------------------?-X--------SSSS--------------
----------XXXXXXXX--------XXXX----------------XXXXXXXX------------------------XXXX----XXXX------------------------XXXXXXXX------------------
XXXXXXXXXXXXXXXXXX--------XXXX--------XXXX----XXXXXXXX----XXXX--------XXXX----XXXXXXXXXXXX----------------XXXX----XXXXXXXX----XXXXXXXXXXXXXX
XXXXXXXXXXXXXXXXXXXXXXXXXXXXXX----XXXXXXXX----XXXXXXXXXXXXXXXX----XXXXXXXXXXXXXXXXXXXXXXXX------------XXXXXXXX----XXXXXXXX----XXXXXXXXXXXXXX
