--------------------------------------------------------------------------------------------------------------------------------------------
--------------------------------------------------------------------------------------------------------------------------------------------
--------------------------------------------------------------------------------------------------------------------------------------------
--------------------------------------------------------------------------------------------------------------------------------------------
---------------------------------------------------------------------o----o-------------------------o-----oo-oo-oo-----o--------------------
------------------------------------o-------o--------------ooo--------o------o----o-o-----o----o---o------------------o---------------------
----------o--------------------------ooo--o-------ooo-o---o-------o-o---oo-----o-o-----------o----o--o------o--o--o-------------------------
--------o---oo------ooo---------o-o-----oo-------o-X--------------??-X??X-------o-----o-oo--o----o-----oo-S??-?-----o---SSo-----------------
------o--o???So--------o----o----o-???-------?o---------------o---------------o----S-X----X-X-??----------------------------oo--------------
-------o---------ooo---------ooo----------------o--------------------------------------o-----------------S--------XS-------o----------------
-------?-?----S-------------?-X-?-------------?SSX------------------------------------S--S---------------------------------?-?--------------
--------------------------------------------------XXXXXXXX--------XXXXXXXXXXXX--------------------XXXX----XXXXXXXX----XXXX------------------
XXXXXX----XXXX--------------------XXXX----XXXX----XXXXXXXXXXXX----XXXXXXXXXXXX----XXXX----XXXXXXXXXXXX----XXXXXXXX----XXXX----XXXX----------
XXXXXX----XXXX--------------------XXXXXXXXXXXX----XXXXXXXXXXXXXXXXXXXXXXXXXXXXXXXXXXXX----XXXXXXXXXXXXXXXXXXXXXXXXXXXXXXXX----XXXXXXXXXXXXXX
