--------------------------------------------------------------------------------------------------------------------------------------------
--------------------------------------------------------------------------------------------------------------------------------------------
--------------------------------------------------------------------------------------------------------------------------------------------
--------------------------------------------------------------------------------------------------------------------------------------------
----------------------------------------------------------------o---------------------------------------o-----------------------------------
----------------------o-----------o---------------------------------o------------------------------------------------o-----o----------------
-----------o-------o------ooo-oo-----ooo--o-oo----o--------------o----oo-o----o------o---------o-oo--oo-----oo--------o------o--------------
----------------o--------o---o----?XX----o-o----o----oo--------------o-------o-----o--o--o--o---o--------X-o-------X------o-----------------
------oo-oo-o----oo-o----?------o-------o---??---o-oo--o-o--o--------X----o----ooo--------oo-------oo-----XS?X---------oooX??---------------
----------??SX??-?--------S?XXX???------------???XX?------o--o--------?S?S-------------oo-X-??XSS-------------ooo-------S?------------------
--------------------------------------------------------------------------S-X?---------??X---------------------?----------------------------
----------------------------------XXXX------------------------XXXX------------------------------------XXXX--------XXXX--------XXXX----------
----------------------XXXX--------XXXX----XXXX----------------XXXXXXXX------------XXXX----------------XXXXXXXX----XXXX----XXXXXXXXXXXXXXXXXX
XXXXXXXXXXXXXXXXXXXXXXXXXXXXXXXXXXXXXXXXXXXXXXXXXXXXXX--------XXXXXXXXXXXX----XXXXXXXX----XXXXXXXXXXXXXXXXXXXX----XXXXXXXXXXXXXXXXXXXXXXXXXX
