--------------------------------------------------------------------------------------------------------------------------------------------
--------------------------------------------------------------------------------------------------------------------------------------------
--------------------------------------------------------------------------------------------------------------------------------------------
--------------------------------------------------------------------------------------------------------------------------------------------
--------oo-------------------------oo-----------------------------oo-o-------------------------------o----------------o--o------------------
-------o--------------oo------o------------o--o--oo--o--------------------------------------------o-o--------------ooo-o--------------------
------------------o--------o---o-o-----o-----------o---o-o----------o----------------o---------o------------ooooo-------o-o--o--------------
-------?SSoo---o---------oo-oo?SS?----o-o-o-oo--o-?S-?------ooo--oS-X-----------o------------------------o-o---?S?------XS--o---------------
--------------o----o-o-----?-X-----------o--X?-S?S------o-------------o-------o--o---S---o-oo---oo-----oo---------X-------------------------
--------------X----------------------------------------S---o---??S----XS-------o--------o-o---X---------------------------????--------------
----------X???------------------------------------------------------------------------SSS-?XSX----------------------------------------------
XXXXXXXXXX--------------------XXXXXXXX------------XXXX------------XXXX----------------------------XXXX--------XXXX----XXXX------------------
XXXXXXXXXX------------XXXXXXXXXXXXXXXX----XXXXXXXXXXXX------------XXXX----XXXX----XXXX------------XXXX----XXXXXXXXXXXXXXXX----XXXX----------
XXXXXXXXXX----XXXXXXXXXXXXXXXXXXXXXXXXXXXXXXXXXXXXXXXXXXXX----XXXXXXXXXXXXXXXX----XXXX--------XXXXXXXX----XXXXXXXXXXXXXXXXXXXXXXXXXXXXXXXXXX
