--------------------------------------------------------------------------------------------------------------------------------------------
--------------------------------------------------------------------------------------------------------------------------------------------
--------------------------------------------------------------------------------------------------------------------------------------------
--------------------------------------------------------------------------------------------------------------------------------------------
------o------------------o-----------------------------------o-----o--------------------------------o---o-------------------o---------------
---------o-----o------o----------------o-----oo--o---------o---o-oo-o-o-------oo-o---------o--o---o--oo--------------------o----------------
-------oo----------o------oo-o---o----o-oo-o------o-o-----o-o--------o-oo-----------------o----ooo-o---o-----ooo-oooo--------o--------------
-------?-?----o-o--------------o---------------oo--o---o---------S?S??--------?-----------?X-----------?-S-----?---------o??S---------------
-------------o----o-o-------o-o--------------?-S-?---o---o------------?S??-oo------------------------------oo---------o-o-------------------
----------o---------------S?-SS-?X--o-------------??X?o-------------------SS?S-----------o----------------S???---------o--------------------
----------?SS---------------------X??X----------------??S------------------------------???-------------------------------X------------------
XXXXXXXXXX------------XXXX--------------------------------XXXXXXXXXXXX--------XXXXXXXX----XXXX----XXXXXXXX----XXXXXXXX----XXXX--------------
XXXXXXXXXX----XXXX----XXXX------------XXXXXXXXXXXX--------XXXXXXXXXXXXXXXX----XXXXXXXX----XXXXXXXXXXXXXXXX----XXXXXXXX----XXXX--------------
XXXXXXXXXX----XXXXXXXXXXXXXXXXXXXX----XXXXXXXXXXXXXXXX----XXXXXXXXXXXXXXXXXXXXXXXXXXXX----XXXXXXXXXXXXXXXXXXXXXXXXXXXX----XXXXXXXX--XXXXXXXX
