--------------------------------------------------------------------------------------------------------------------------------------------
--------------------------------------------------------------------------------------------------------------------------------------------
--------------------------------------------------------------------------------------------------------------------------------------------
--------------------------------------------------------------------------------------------------------------------------------------------
-------------------o---------o-----------------------------------------o------------------------o-------------------------------------------
-----------------------o--o--------o-o-----o--------o----oo-----------o-------------------ooo--o--o------------------o-----o----------------
---------o-o-----o--oo---o-oo-------------------o--o-------oo-o--o-------o-----o-------------------o-o-------------o--oo--o-o---------------
------oo--o----o-----------S?S--o--?X---o-o-------o--o-o-----------o-oXX??--o---o------o-----o?X----o----------oo---------S-SS--------------
----------X??-?S----------------------oo----?--o--X-?S??----------o--------------o--------??XS------------o--oo--o-------o------------------
--------XS--------------------oo---------o----X???----------------?SX--------o---?------o----------------o-o--?SSX--------------------------
------------------------------XSX?----------------------------------------------------??S-------------------?X------------------------------
------------------XXXX----XXXX----XXXX--------------------XXXX--------XXXX--------------------XXXX----------------XXXX----XXXX------XXXXXXXX
----------XXXXXXXXXXXXXXXXXXXX----XXXX----XXXX----XXXXXXXXXXXX--------XXXX----------------XXXXXXXXXXXX------------XXXX----XXXX------XXXXXXXX
XXXXXXXXXXXXXXXXXXXXXXXXXXXXXX----XXXX----XXXXXXXXXXXXXXXXXXXXXXXXXXXXXXXX----XXXXXXXX----XXXXXXXXXXXX--------XXXXXXXXXXXXXXXX------XXXXXXXX
