--------------------------------------------------------------------------------------------------------------------------------------------
--------------------------------------------------------------------------------------------------------------------------------------------
--------------------------------------------------------------------------------------------------------------------------------------------
--------------------------------------------------------------------------------------------------------------------------------------------
--------------------------------------------------oo-------------------------------o--------------------------------------------------------
-------------------o-o--------oo--------------------o-------------------------o-o---oo-o-oo------------------------------o------------------
-----------o--oo--o-o-o-----------oo---o--------o----------------o--o-ooo------o--o-----o--oo------oo---o---------------o-------------------
---------o---o---------o-----o--oo----o------oo--oS?---o----ooo----o-o------o-------X-???X---o-------------o-oo-------oo--o--o--------------
----------o-----------------o-X-S-------oo----S?XS---------o---o-----------o-o------------S??--oo-o--ooo-------o----o----X-o----------------
--------o-S-?S----------X?o------------------------------oo------XX??---S?S---------------------------??-?o-o---o-----------o---------------
------SS?S----------------X?X?---------------?------------------------------------------------?-----------?XX-S?X?--------???---------------
----------------------------------XXXX------------XXXX------------------------XXXXXXXXXXXX--------------------------------------------------
--------------XXXXXXXX--------XXXXXXXX--------XXXXXXXX------------------------XXXXXXXXXXXXXXXX------------------------XXXX----XXXXXXXXXXXXXX
XXXXXX----XXXXXXXXXXXXXXXX----XXXXXXXXXXXX----XXXXXXXX--------XXXXXXXXXXXXXXXXXXXXXXXXXXXXXXXX----XXXXXXXX--------XXXXXXXX----XXXXXXXXXXXXXX
