--------------------------------------------------------------------------------------------------------------------------------------------
--------------------------------------------------------------------------------------------------------------------------------------------
--------------------------------------------------------------------------------------------------------------------------------------------
--------------------------------------------------------------------------------------------------------------------------------------------
----------------------oo----------------------------------------oo-----------o--------oooo------------ooo------------o----------------------
---------------ooo--o-----------o--------------o-o-----o----------------------oo-------------------------oo-o-------o--o--------------------
-------------------o-o-------o---------o-o----------o------o---o--------o-------o--------------------------o------o---o-o-oo-o--------------
---------o--------------SS--o-o-------o-o---o-o----o--------oo--------oo---------S----??X?oo------o--o---?---oo---?-------------------------
----------o--o-------?-----o----X?o--o--------SX?So--oX-X------------o?S?---------o-------??--------o-----X-?X------------?-X---------------
--------o-----------------S-SX----??------o-------S?X?--------------o--------------------------o---o------------o---------------------------
------???S?X-?---------------------------------------------------------------------S-?-------------------------???--------------------------
----------------------XXXX------------------------------------XXXX--------XXXXXXXX----XXXX------------XXXX--------XXXXXXXX------------------
XXXXXX--------XXXXXXXXXXXX----XXXX------------XXXX----XXXX----XXXX----XXXXXXXXXXXX----XXXXXXXX--------XXXXXXXX----XXXXXXXXXXXXXXXX----------
XXXXXX--------XXXXXXXXXXXXXXXXXXXXXXXXXXXX----XXXXXXXXXXXXXXXXXXXX----XXXXXXXXXXXX----XXXXXXXX--------XXXXXXXX----XXXXXXXXXXXXXXXXXXXXXXXXXX
