--------------------------------------------------------------------------------------------------------------------------------------------
--------------------------------------------------------------------------------------------------------------------------------------------
--------------------------------------------------------------------------------------------------------------------------------------------
--------------------------------------------------------------------------------------------------------------------------------------------
------------------------------------o--------------------------------o----------------------------------------o--------------o--------------
---------o---------------ooo----------oooo-o---------------------------o-o--o---------------------o-----------------------o-o---------------
------o-o--o-ooo--o-o---o---oo-o------------o-----------oo------o-----------------------------o-o--oo-----o-o--------------o----------------
-------------------o-o--------o-oo--------o--o--o---o--------oo---S?X?o---------------o----o---o-o----oo------S?-?X----o--?-?X--------------
-------?X---o-------------?-??XXX----------??S-o---o-oS?--ooo--o------??------oo---oo-----o---?XX----------o-o----------oo------------------
----------XX??-----------------------------------oXX-X----------SX---------------oo-----oo?-X?--------------XX------------------------------
-----------------------------------------------S??-------------------------------------?X---------------SS--------------S-------------------
----------------------------------XXXXXXXX------------------------XXXX----------------------------------------XXXXXXXX----XXXXXXXX--XXXXXXXX
XXXXXXXXXX------------XXXXXXXXXXXXXXXXXXXXXXXX--------XXXX--------XXXXXXXXXXXX----------------XXXXXXXX--------XXXXXXXX----XXXXXXXX--XXXXXXXX
XXXXXXXXXXXXXXXXXXXXXXXXXXXXXXXXXXXXXXXXXXXXXX----XXXXXXXX----XXXXXXXXXXXXXXXX------------XXXXXXXXXXXX----XXXXXXXXXXXX----XXXXXXXX--XXXXXXXX
