--------------------------------------------------------------------------------------------------------------------------------------------
--------------------------------------------------------------------------------------------------------------------------------------------
--------------------------------------------------------------------------------------------------------------------------------------------
--------------------------------------------------------------------------------------------------------------------------------------------
-----------------------------o---------o-o----------o-------------------------o---------------o---------------o-----------------------------
---------ooo----------------o----------------------------------------------------o-----------------------------oo-o--o----------------------
-------o----o-------------oo----------o----o---o--o------o----o----ooo---------o-----------------o----------o----o--------------------------
--------o------ooo-o-o----XX?---o-o-o-------------?XS-----o-o-----o---oo----o-----o--o---o-o--SX------o---o---S----o----o--o----------------
------?X??S?X-----o-o----o----oo----------------oo----XXX--o-------X-S----?------------oo-o-o--------o-----o----------oo-o--o---------------
-----------------------o------?S???SS----------S?----------------------??----------o------??S?----oo-----XX?-S----------?-o-----------------
-----------------------?S---------------------------------?---------------------------????--------------------------------?-?---------------
--------------------------XXXX--------XXXX--------XXXX--------XXXX------------XXXX------------XXXX------------XXXX----------------XXXXXXXXXX
XXXXXXXXXXXXXX------------XXXX--------XXXX--------XXXXXXXX----XXXXXXXX----XXXXXXXX------------XXXX------------XXXXXXXX------------XXXXXXXXXX
XXXXXXXXXXXXXX------------XXXXXXXXXXXXXXXXXXXXXXXXXXXXXXXX----XXXXXXXXXXXXXXXXXXXX--------XXXXXXXX----XXXXXXXXXXXXXXXXXXXX----XXXXXXXXXXXXXX
