--------------------------------------------------------------------------------------------------------------------------------------------
--------------------------------------------------------------------------------------------------------------------------------------------
--------------------------------------------------------------------------------------------------------------------------------------------
--------------------------------------------------------------------------------------------------------------------------------------------
---------------------------------------------------o----o-----o----------------o-o----------------------------------------------------------
--------o---------------o-----------------------o-o---------------------------o-o--------------------------------------oo---o---------------
------o----------o-o--o----o-------o-o---------o-----o----------o-------o-o-o------------------------o-----------------------o--------------
-------o-o----o-------------oo------o------------oSSXX??--o---------o-oo-----o-----o------o-----oo-o--o---oo--oo----------oo----------------
------X-??o-o---o-o-oo--?-o---o-------o---o-o--XX----------o-o-------oS-SS-o------o----ooo--o--o--o-o-------oo??---o----?X--S---------------
-------------o?------------??S-o-------oo----?--------------o-------------?---------o-?XS--o--o----------SX-?S-------o----------------------
-----------XS?-----------------X?S----------------------------------X---------------??-------S?S?-------------------------------------------
--------------------------------------------------XXXXXXXX----XXXX------------XXXX----------------------------------------------------------
XXXXXXXXXX------------XXXX--------XXXX--------XXXXXXXXXXXX----XXXX----XXXX----XXXX----------------------------XXXX----XXXXXXXX--------------
XXXXXXXXXX----XXXXXXXXXXXXXXXX----XXXX----XXXXXXXXXXXXXXXX----XXXX----XXXXXXXXXXXX----XXXX--------XXXXXXXXXXXXXXXX----XXXXXXXXXXXXXXXXXXXXXX
