--------------------------------------------------------------------------------------------------------------------------------------------
--------------------------------------------------------------------------------------------------------------------------------------------
--------------------------------------------------------------------------------------------------------------------------------------------
--------------------------------------------------------------------------------------------------------------------------------------------
--------o-----o---------------------------------------o--------------o-------------------------------------------------ooo------------------
-------o-----------o-------------o---------------------o-----------o---oo---o---------------------------------------o-----------------------
---------o------oo--o-------------ooo---oo--------------o--o-------------o---oo---o----o------oo-o------------oo-----oo---------------------
------XXSX-o--?S--------------ooo-----oo-----oo-oo-o--??----o---o-?-?-o----------o---o--o-o-o-----o-o-------------------S-------------------
----------o--o--------------o-?S----------oo--------oo----o-----------?-?S-----oo-----o--o-o-o--o-------------------------------------------
-----------S-X---------------------------------SX----------------o--------------?-----?-S???-X-----o--oooo--oo-------------ooo--------------
-------------------------------------------X-?----??X?----------S-------------------------------------?-????S?------------X-X---------------
XXXXXXXXXX----XXXX----XXXX----------------------------XXXX--------XXXX------------------------------------------------XXXX------------------
XXXXXXXXXX----XXXXXXXXXXXX----XXXXXXXX----------------XXXX--------XXXXXXXXXXXX------------------------------------XXXXXXXX--------XXXXXXXXXX
XXXXXXXXXXXXXXXXXXXXXXXXXXXXXXXXXXXXXXXXXX----XXXX----XXXXXXXX----XXXXXXXXXXXXXXXXXXXXXXXXXXXXXXXX------------XXXXXXXXXXXX--------XXXXXXXXXX
