--------------------------------------------------------------------------------------------------------------------------------------------
--------------------------------------------------------------------------------------------------------------------------------------------
--------------------------------------------------------------------------------------------------------------------------------------------
--------------------------------------------------------------------------------------------------------------------------------------------
--------------------oo--------o---------------------------oo-o-oo---------------------o-----------------------------------------------------
-------------o-----------------o-o--------------------------o-o-----oo------------------oo---o-------o--------o-o-o-------------------------
----------o-------oo---o-o---o--o----------o------oo---------------o------o-oo----oo---o------oo--ooo---o-----------o--o--o-o---------------
-----------oo--o--------------?-?---o---o-------------------------SSXX----------oo--o-SX-Xo-o----o--------o-ooXXS----oo---------------------
--------o-??S?--------o-----o-----o--o-o----XS------oo-o-o---------------o?----o----------XSX-XSS--------X--------------??------------------
-------o----------------?XX-?X----?--?-----------o?X-?----------------oo-----------------------------------o---------------X-?--------------
------?--?------------------------------------S-X---------------------S?----------------------------------????------------------------------
------------------XXXX--------XXXX------------------------XXXXXXXXXXXX----------------XXXX--------------------XXXX--------------------------
XXXXXX----XXXX----XXXX--------XXXX--------XXXX------------XXXXXXXXXXXX----XXXX----XXXXXXXXXXXXXXXXXXXXXXXX----XXXXXXXXXXXX------------------
XXXXXX----XXXXXXXXXXXXXXXXXXXXXXXXXXXX----XXXX----XXXX----XXXXXXXXXXXX----XXXX----XXXXXXXXXXXXXXXXXXXXXXXX----XXXXXXXXXXXXXXXX------XXXXXXXX
