--------------------------------------------------------------------------------------------------------------------------------------------
--------------------------------------------------------------------------------------------------------------------------------------------
--------------------------------------------------------------------------------------------------------------------------------------------
--------------------------------------------------------------------------------------------------------------------------------------------
-----------------------------------------------ooo------o-----------o----------o------------------------------------------------------------
--------------o--------o----------------------o--------------------o-ooo------------------------oo----o----o----------o---------------------
---------------oo--oo---o--o---------------oo---------------------o-----o----o--oo-o-o--------------------o--o------o--oo-------------------
--------oo-----------o----o-oo---o--oo-oo-o---X?S-oo-----------oo-?-??-----o--------S--o--oo--o----oo--o----o-o-o--------o---o--------------
---------------??--------?-XSS--------o--o----------------oooo--------X--?--------------oo--ooX--Xo--o----X-?X-------------oo---------------
----------oo------------------oo-----------S-?-------------------o--------------------o---------------------------??-------?----------------
------X?-S-???----------------?S?-----------------S-----------------------------------X?S??S------------------S??S--------------------------
----------------------------------------------XXXX----XXXX--------XXXX--------XXXXXXXX------------------------------------------------------
XXXXXX--------XXXXXXXXXXXXXXXX----------------XXXX----XXXX--------XXXXXXXX----XXXXXXXX--------XXXX----XXXXXXXX--------XXXX--------XXXXXXXXXX
XXXXXX--------XXXXXXXXXXXXXXXX--------XXXXXXXXXXXX----XXXXXXXX----XXXXXXXXXXXXXXXXXXXX--------XXXX----XXXXXXXX----XXXXXXXXXXXX----XXXXXXXXXX
