--------------------------------------------------------------------------------------------------------------------------------------------
--------------------------------------------------------------------------------------------------------------------------------------------
--------------------------------------------------------------------------------------------------------------------------------------------
--------------------------------------------------------------------------------------------------------------------------------------------
------ooooo---------------------------------------------------o--------------------o--------------------------------------------------------
-----------oo-----------------------------------------o-o-------o-------------o---o-o------------o--------------------o---------------------
---------------o-----o------oo-------------------------------------ooo---------o-o--------o-o------------o---------------o------------------
------X-?S?XS?--o--oo--o--------o------oo-o--o-o------S----------?---------o-----------o---???--o-o-----------o------o-oo---oo--------------
------------------o---o---o---o----oo----o--------o--------ooo--------o---o--o----------o-----X-X--o-oo---o-oo--o-------X--o----------------
--------------S-------------SX-------oo-----S?---o-oo-----o-------?-??-oo-X-S------------o----------o---X?-o--X-----------o-----------------
------------------------?X----S--S-?----------???X-S?-----------------??----------------S-----------------?X?X------------?--?--------------
XXXXXXXXXXXXXX----------------------------------------XXXX----XXXX----------------XXXX----XXXX----------------------------------------------
XXXXXXXXXXXXXX----------------------------------------XXXX----XXXX------------XXXXXXXX----XXXXXXXX--------------------XXXX------------------
XXXXXXXXXXXXXXXXXXXXXX----XXXX------------XXXX--------XXXX----XXXXXXXX----XXXXXXXXXXXX----XXXXXXXX----XXXX----XXXX----XXXX----XXXXXXXXXXXXXX
