--------------------------------------------------------------------------------------------------------------------------------------------
--------------------------------------------------------------------------------------------------------------------------------------------
--------------------------------------------------------------------------------------------------------------------------------------------
--------------------------------------------------------------------------------------------------------------------------------------------
--------------o-o--o--------------------o------------------------------------oooo------------------oo-------------------o-------------------
-----------------oo-----------------------------o-----------o--------------oo-----oo--------------o---o------o---------o-----o--------------
------o-o-o--o------oo-----oo----------o-------o-oo-----o-----------------o------o--------oo---o-----o-----o--o-o---o----o------------------
--------------X?S-S---o--------------------o--------------oo-o--o----o--ooX----------oo---------o--------?--o--o----------ooo---------------
-------o----o------------o---o------------o----???-o-oo--o---S-o------oo----------S?SS-o----oo------------X-XX?S?S-o-o----X?S?--------------
--------SX???X----------o----X--o-?---------------?S-------------?-oo--------------------oX-XX?--------------------?------------------------
------------------------------?-S---------------------------------?-S?----------------???S--------------------------------------------------
--------------XXXXXXXX----------------XXXX--------------------------------XXXXXXXX----------------XXXXXXXX------------XXXX----XXXX----------
--------------XXXXXXXX----------------XXXX----XXXX--------XXXX------------XXXXXXXXXXXX------------XXXXXXXXXXXXXXXX----XXXXXXXXXXXXXXXXXXXXXX
XXXXXXXXXXXXXXXXXXXXXX----XXXX----XXXXXXXXXXXXXXXXXXXXXXXXXXXXXXXX----XXXXXXXXXXXXXXXX----XXXXXXXXXXXXXXXXXXXXXXXXXXXXXXXXXXXXXXXXXXXXXXXXXX
