--------------------------------------------------------------------------------------------------------------------------------------------
--------------------------------------------------------------------------------------------------------------------------------------------
--------------------------------------------------------------------------------------------------------------------------------------------
--------------------------------------------------------------------------------------------------------------------------------------------
------------------------------------------------------------------------------oo-o-------------------o------------o-------------------------
--------------oo-----oo-oo-o--o---------o------o-o---------------------------------o-o--o-----o--oo-------------o----ooo---oo---------------
------------o---o-ooo--o----oo--------oo--------------------oo----o--o----------o-o-o----o-oo---o--oo---------o-----------o-----------------
------oo-oo---------------SSX--X??-------o----XSS?---------o----------o--o------------o-----?SX----------o---------------o------------------
-----------o-----------??S-----------------o------ooo---S---------------o---o----------S?--------------o-----oX??---------??S---------------
--------o-X------------------------?---------?-------o----------XS?-SX?XXX----------------------------o-o--oo-------------------------------
---------?----------------------------------------SS----------------------?-----------------------------XS?-SS------------------------------
--------------XXXXXXXX----XXXXXXXX------------XXXX----------------------------XXXXXXXX----XXXXXXXXXXXX------------XXXX--------XXXX----------
--------------XXXXXXXXXXXXXXXXXXXX----XXXX----XXXX----XXXXXXXX----------------XXXXXXXXXXXXXXXXXXXXXXXX--------XXXXXXXXXXXXXXXXXXXXXXXXXXXXXX
XXXXXX----XXXXXXXXXXXXXXXXXXXXXXXXXXXXXXXXXXXXXXXX----XXXXXXXXXXXXXXXXXXXX----XXXXXXXXXXXXXXXXXXXXXXXX--------XXXXXXXXXXXXXXXXXXXXXXXXXXXXXX
