--------------------------------------------------------------------------------------------------------------------------------------------
--------------------------------------------------------------------------------------------------------------------------------------------
--------------------------------------------------------------------------------------------------------------------------------------------
--------------------------------------------------------------------------------------------------------------------------------------------
----------------------------oo-o--o-o----------o----o-------o-------------------------------------------------------------------------------
-----------o------------------o------o----------ooo--o-----o-o--------o-o-----------------------------------------------o-------------------
------o-oo----------------oo-----o----------o------o------o-------------------o------------o------oo-o-------------------o--o---------------
-------X?X------------------S-SS--?S----oo----SX?XSXS----o----------o----o------o-o-----ooo-oo-o------o--oo-o-o-------oo--------------------
----------??XX---o-ooo--o-----------------o--o--------o--------oo-----?XX--o-o-o---S-?XXS?----------o------o-o-oo-o-----?-o--o--------------
---------------------------------------o--------------------------o--o---------------------XSSo--------o--X-??X----o------?XSS--------------
--------------X?-S----------------------------------------------S???-S-------------------------??------S?-----------------------------------
XXXXXXXXXX----------------XXXXXXXXXXXX--------XXXXXXXX----XXXX------------------------------------------------------------------------------
XXXXXXXXXXXXXX------------XXXXXXXXXXXX--------XXXXXXXX----XXXX--------XXXX--------XXXXXXXX----------------------------XXXX----XXXXXXXXXXXXXX
XXXXXXXXXXXXXX--------XXXXXXXXXXXXXXXX----XXXXXXXXXXXX----XXXX--------XXXX----XXXXXXXXXXXXXXXX----XXXX----XXXXXXXX----XXXXXXXXXXXXXXXXXXXXXX
