--------------------------------------------------------------------------------------------------------------------------------------------
--------------------------------------------------------------------------------------------------------------------------------------------
--------------------------------------------------------------------------------------------------------------------------------------------
--------------------------------------------------------------------------------------------------------------------------------------------
----------oo-o-----------------o-----------------------------o--------oooo------------------------o-o---------------------------------------
------------o-oo--o-----------o-o-------------------------o-o-----------------------------oo----------------------o-o-o-o-o-----------------
-------------------o---------------------------------------o--o------------------------------------o-o------oo---------o-o-oo---------------
----------?-?---o---o---------S?----o---o-------o-o---o--------o------?SX-S?---------?------SSo----------------oo----o----?X?---------------
------o-o-----S-------------o---------oo-o-ooo---o-o-o--o-------o-oo------------oo-----oo------o-o--------S?X?---o--------------------------
---------o-----------------o-------o------o---o-------S?------------o---------oo---------o----S???------oo----o-----------------------------
------?X?S-----------------???--------------?S--????-?------------XX-S------------------?----------------X----??----------------------------
XXXXXX----XXXX----------------XXXX------------------------XXXX--------XXXXXXXX----XXXX----XXXX----XXXX--------------------XXXX--------------
XXXXXX----XXXXXXXXXXXX--------XXXX------------------------XXXX--------XXXXXXXX----XXXX----XXXX----XXXX----XXXX----XXXXXXXXXXXX--------------
XXXXXX----XXXXXXXXXXXX--------XXXX----XXXX------------XXXXXXXXXXXX----XXXXXXXX----XXXX----XXXXXXXXXXXX----XXXX----XXXXXXXXXXXX----XXXXXXXXXX
