--------------------------------------------------------------------------------------------------------------------------------------------
--------------------------------------------------------------------------------------------------------------------------------------------
--------------------------------------------------------------------------------------------------------------------------------------------
--------------------------------------------------------------------------------------------------------------------------------------------
----------o---------o---------o----o----------------------------------------------------------------------------o------o--------------------
------o--------------------ooo---o---o-------------oo-o----oo-oo------o-o-----------------------------o-ooo----o---------o------------------
-------ooo-o------o--o----o---------o--oo------------o---o---o------------------------------------o--o------ooo-------o-o---o---------------
-------SXXX?X?--------o---------???X--o-------ooo-o------Xo----------------o----------------o----o--o-----XXSSS?X-o-----?-o-----------------
----------------------------S?-------------ooo---o-??X------------oo--SX?-----oo-----o--oooo---o---o--?-X--------------------o--------------
--------------S-----------------------------------------------------oo----------o-o-----??-??X------SX--------------o-----S?S---------------
----------------------------------------------?-??----------------XSX------S----------------------------------------------------------------
XXXXXXXXXXXXXX----XXXX--------XXXXXXXX----------------XXXX----XXXX----------------------------------------XXXXXXXX----XXXX----XXXXXXXXXXXXXX
XXXXXXXXXXXXXX----XXXX----XXXXXXXXXXXX------------XXXXXXXXXXXXXXXX----XXXX----------------------------XXXXXXXXXXXX----XXXX----XXXXXXXXXXXXXX
XXXXXXXXXXXXXXXXXXXXXX----XXXXXXXXXXXXXXXX--------XXXXXXXXXXXXXXXX----XXXX------------XXXXXXXX----XXXXXXXXXXXXXXXX----XXXXXXXXXXXXXXXXXXXXXX
