--------------------------------------------------------------------------------------------------------------------------------------------
--------------------------------------------------------------------------------------------------------------------------------------------
--------------------------------------------------------------------------------------------------------------------------------------------
--------------------------------------------------------------------------------------------------------------------------------------------
-----------o---o----oo----o--o------------o-------------------------------------------------------------------------------------------------
------------o-o---o---o-----o-oo------o-o--oo------------------------------------------------------o-o-----------------o--------------------
-------------------o---o---------o-------------------------oo--o------------o-----------o---o-----o-o--------o----o--oo--o-oo---------------
-------o--?XXS?S-------------------------o-------o-o----oo---o-------oo--------o---------o---o------------o----o-o-o---------o--------------
-------------------------------???---o----------o-o----------------o------oo------oo--o---oo----------------o-----?-?---?X-?S?--------------
---------o------------------------------------XX?SSX?So--------?----o--oooX---o-oo--ooSXSXXX-?o-o----------?-?o-----------------------------
------?S-?--------------------------------------------?S-------------S--??----------?S--------S----------------???--------------------------
XXXXXX----XXXXXXXXXXXXXXXXXXXX------------XXXX--------------------------------------------------------XXXX--------------------XXXX----------
XXXXXX----XXXXXXXXXXXXXXXXXXXXXXXX----XXXXXXXX------------XXXX------------------------------------XXXXXXXX--------XXXXXXXXXXXXXXXX----------
XXXXXX----XXXXXXXXXXXXXXXXXXXXXXXX----XXXXXXXXXXXXXXXX----XXXXXXXX--------XXXX--------XXXXXXXX----XXXXXXXXXXXX----XXXXXXXXXXXXXXXXXXXXXXXXXX
