--------------------------------------------------------------------------------------------------------------------------------------------
--------------------------------------------------------------------------------------------------------------------------------------------
--------------------------------------------------------------------------------------------------------------------------------------------
--------------------------------------------------------------------------------------------------------------------------------------------
-------------o-----ooo------------o------o--------oooo--------o--o------------o-------------------------------------------------------------
-----------oo----o---------------------o-----------------------o-----------------o----------------------------o-----o-----o-----------------
----------o----o------------o---------o-o-----------------------o-------oo-----oo------oo--oo-----------o-o--o----o--------o----------------
----------???X?S--------oo--------S-------oo-o----?-??---------S-X----oo---o------o------oo------ooo---o-------o-------o----oo--------------
-------ooo----------------oo-o--o-------------o--o----------oo------oo----o---------o--?XX-XS-------o------o--?S?----------?-S--------------
------X-?-------------------SSoo---------------oo-----X-?-oo-------o---?-X--o--------X--------o------o---?-??------------X------------------
------------------------------??SX------------X-?S-----------?----XX-?----?--?----------------S---------------------------------------------
----------XXXXXXXXXXXX------------XXXXXXXX--------XXXX--------XXXX------------XXXX----------------------------------------------------------
----------XXXXXXXXXXXXXXXX--------XXXXXXXX--------XXXX--------XXXX------------XXXX----XXXXXXXX----------------XXXXXXXX----XXXX----XXXXXXXXXX
XXXXXXXXXXXXXXXXXXXXXXXXXXXXXX----XXXXXXXX--------XXXXXXXX----XXXX----XXXX----XXXXXXXXXXXXXXXX--------XXXXXXXXXXXXXXXXXXXXXXXXXXXXXXXXXXXXXX
