--------------------------------------------------------------------------------------------------------------------------------------------
--------------------------------------------------------------------------------------------------------------------------------------------
--------------------------------------------------------------------------------------------------------------------------------------------
--------------------------------------------------------------------------------------------------------------------------------------------
---------o----------------------------------------------------------------------------------------------------------------------------------
----------------o---o----------------------o------------------------o------------------oo-oo-----------oo---------o---------o---------------
-------oo---------oo-o-o---o-o--------o--o--o------o----------o------o--oo-------o----o--o--oo-----------o---o--o-------o----o--------------
-------??--o-o----------o---o-oo-oo----oo--------------o-------o-o???-o---o-----------X-XS-?-----o-o---S?X-----o----o-----o-----------------
----------o-----------o--oXX--------o---------ooooo--------oo---X?----?S----o-ooo--oo----------o--o-oo-----oo-o---S---oo--??SS--------------
-----------------------------------?--------------SS------o-------------------------S?--------------------?XS??-?-------?-------------------
----------?-?-------------------?---------------S?----X?-----?------------------------------------------------------------------------------
XXXXXXXXXX--------------------------------------------------------XXXX----------------XXXXXXXX--------XXXX----------------------------------
XXXXXXXXXX----XXXXXXXX----XXXX--------XXXXXXXX----------------XXXXXXXXXXXX------------XXXXXXXX--------XXXX--------XXXX----XXXX----XXXXXXXXXX
XXXXXXXXXX----XXXXXXXXXXXXXXXX----XXXXXXXXXXXX----XXXX--------XXXXXXXXXXXX----XXXXXXXXXXXXXXXXXXXXXXXXXXXXXXXXXXXXXXXXXXXXXXXXXXXXXXXXXXXXXX
