--------------------------------------------------------------------------------------------------------------------------------------------
--------------------------------------------------------------------------------------------------------------------------------------------
--------------------------------------------------------------------------------------------------------------------------------------------
--------------------------------------------------------------------------------------------------------------------------------------------
----------------o------o---o-o-----------------------------o---------------------o----o----------------o------------------------------------
--------------------------o-o---oo---------o--------------------o---------------o------oo-oo----o-----o--o-------------o--------------------
---------------------oo-oo--------------------------------o-o----o---o--------o----------o--------------o-----oo------o--o------------------
---------oo--------oo-----S-??o---o---oo-oo-o---oo----o----X----------o-o---o---------?-XX-S-??----------------??----------o-o--------------
------------o------------------?-S---o--o--?XX-o------------------o-o--o--X?----------------------o--o------o------o----??------------------
------oo---------------------------------------??-o--o?X----------X??----o--------------------------o-----o--o------------o-o---------------
----------XX?---------------------XX-?-------------?X-----------------??-X-----------?-----------------------?---------------?--------------
XXXXXX--------XXXX----XXXXXXXX----------------------------XXXX----------------XXXX----XXXXXXXXXXXX----XXXX----XXXX--------------------------
XXXXXX--------XXXX----XXXXXXXXXXXX--------XXXX------------XXXXXXXX--------XXXXXXXX----XXXXXXXXXXXX----XXXX----XXXX----XXXX----XXXX--XXXXXXXX
XXXXXX--------XXXXXXXXXXXXXXXXXXXX--------XXXXXXXX----XXXXXXXXXXXXXXXX----XXXXXXXX----XXXXXXXXXXXX----XXXX----XXXX----XXXX----XXXX--XXXXXXXX
