--------------------------------------------------------------------------------------------------------------------------------------------
--------------------------------------------------------------------------------------------------------------------------------------------
--------------------------------------------------------------------------------------------------------------------------------------------
--------------------------------------------------------------------------------------------------------------------------------------------
------oo-----o-----------------------------------o--------------------------------------------------------o--o------------------------------
---------o--o---------o-----o------------o----o-o---o-------------o--o--------------o-----------o----o------o-------------------------------
--------o-oo-----o--o-----oo-o--------ooo------o--o----------------------------o------------o-o---ooo-o-o-------------o---------------------
--------?X?--S-o---o-o-----?S-oo--------------S?-X?SX-o---oo---o-o-oo---------------??--oooo---o-o--------X-?X-------o-o-----o--------------
--------------o---o--------------o--o------------------------------???o---oo-o---o---------?-XX?----------------o---o----oo-----------------
--------------??-?-------------------------o-----------o----ooo--------o---------------------------------?----o---------SS--o---------------
------------------------------X-???-?--------?--------?---------?X----??---------------SSS--------------------S-?---------?S??--------------
XXXXXXXXXXXXXX--------XXXXXXXX--------XXXX----XXXXXXXX----------------------------XXXX------------XXXX----XXXX------------------------------
XXXXXXXXXXXXXX--------XXXXXXXX--------XXXX----XXXXXXXX------------XXXX------------XXXX----XXXXXXXXXXXX----XXXX------------------------------
XXXXXXXXXXXXXXXXXXXXXXXXXXXXXX--------XXXX----XXXXXXXX------------XXXX----XXXXXXXXXXXX----XXXXXXXXXXXXXXXXXXXX--------XXXX----XXXX--XXXXXXXX
