--------------------------------------------------------------------------------------------------------------------------------------------
--------------------------------------------------------------------------------------------------------------------------------------------
--------------------------------------------------------------------------------------------------------------------------------------------
--------------------------------------------------------------------------------------------------------------------------------------------
----------o-o----o----oooo-----o--------o-----------------------------------------------------------------ooo-------------------------------
--------------o-o---------------------oo-----------------oo-----------------------------------o---------------------------------------------
-----------o---o--o-oo----o---o--o----------------o--oo---------------o-o----o---------o-o------o-----o------o--------oo-o------------------
-----------?-X?------------ooo?S?-o--------------o---------o-o---------o----------------o-o----o-o-o----S--X?X-o--------S?-oo---------------
-------------------o------??S-------o--------o------o--------?------o-------o--oooo--o---S-o-o----o--o-----------------------o--------------
-------oo---------------------------S--------------S----------o---o--oS---S?S-X-------------------------------o-o-----------?---------------
------?----------------------------------------S-X-------------?XS????--------------------S?-?----------------?-----------------------------
XXXXXX----XXXXXXXX----XXXX----XXXX----XXXX------------------------------------------------------------XXXXXXXX--------XXXX------------------
XXXXXX----XXXXXXXX----XXXXXXXXXXXX----XXXX------------XXXXXXXX------------------------XXXX----XXXX----XXXXXXXX--------XXXX--------XXXXXXXXXX
XXXXXX----XXXXXXXXXXXXXXXXXXXXXXXXXXXXXXXX--------XXXXXXXXXXXX--------XXXXXXXXXXXX----XXXX----XXXX----XXXXXXXX----XXXXXXXXXXXX----XXXXXXXXXX
