--------------------------------------------------------------------------------------------------------------------------------------------
--------------------------------------------------------------------------------------------------------------------------------------------
--------------------------------------------------------------------------------------------------------------------------------------------
--------------------------------------------------------------------------------------------------------------------------------------------
------o--o-----o------------------o--------------o--------------------------------------------o-----o---------------------------------------
--------------------oo-------------oooo-o-----o----------o--oo----o--o------------o-------oo-------o----------------------------------------
-------------o--o-oo-----------o--------------------------oo---------------o-ooo-------------o--oo---o-----ooo---------ooo-o----------------
------?-?--oo----------o----------?------------??Xo--o--------oo----o-------o---o--o-------?S-X?---------o----ooo-----------oo--------------
----------o--------------o-oooo--o----------------?---------------X-??oo-o-------o----oo--------------oo--o---------------o-----------------
----------???---------o-------XSXS-------------------------------o----?SS?-??-----------o-------------XS???XXSS-X----o--?-------------------
-------------------------S--?-----------------------------------X---------------------------------------------------------------------------
XXXXXXXXXX----XXXX----------------XXXXXXXX----XXXX--------XXXX----------------------------XXXXXXXXXXXX------------------------XXXX--XXXXXXXX
XXXXXXXXXX----XXXXXXXX------------XXXXXXXX----XXXXXXXXXXXXXXXX----XXXX------------XXXX----XXXXXXXXXXXX------------------------XXXX--XXXXXXXX
XXXXXXXXXXXXXXXXXXXXXX--------XXXXXXXXXXXX----XXXXXXXXXXXXXXXX----XXXXXXXXXXXXXXXXXXXX----XXXXXXXXXXXXXXXXXXXXXXXX----XXXXXXXXXXXX--XXXXXXXX
