--------------------------------------------------------------------------------------------------------------------------------------------
--------------------------------------------------------------------------------------------------------------------------------------------
--------------------------------------------------------------------------------------------------------------------------------------------
--------------------------------------------------------------------------------------------------------------------------------------------
----------o-----------------o----------oo-----o--o----------------------------o-o------o-o---------o-----------------------o----------------
-----------o------o--o----oo-o-----o------------o----oo-o--o------o------------o-o--------o-----------o-oo----o----------o------------------
---------o--o------oo---------oo-----o---o---------oo-----o--o--------o-----------------o---o--o--o-o------------------o--o-o---------------
------o---S?SX-o----------S--X---o--o----------X?Xo----o-o--o-o------o--o---------------?X-o-o---o--------------??o-----X-?S??--------------
-------oo--------------o-o----?-XSS-------o-------?S?-X-----------?SX?-o-o--o--------------S?Xo-o--------So--o------------------------------
------X?-?------------o------------------------------------------o-----?-?oo-------o------------------------o-------------------------------
----------------------S--?--------------------------------------?S---------??-----------------------------X-??------------------------------
----------XXXX----XXXX----XXXX--------XXXX----XXXX----------------------------XXXX----XXXX--------XXXX--------XXXX----XXXXXXXX--------------
----------XXXX----XXXX----XXXXXXXXXXXXXXXX----XXXXXXXXXXXXXXXX----XXXX--------XXXX----XXXXXXXX----XXXXXXXX----XXXXXXXXXXXXXXXXXXXXXXXXXXXXXX
XXXXXXXXXXXXXX----XXXX----XXXXXXXXXXXXXXXX----XXXXXXXXXXXXXXXX----XXXXXXXX----XXXX----XXXXXXXXXXXXXXXXXXXX----XXXXXXXXXXXXXXXXXXXXXXXXXXXXXX
