--------------------------------------------------------------------------------------------------------------------------------------------
--------------------------------------------------------------------------------------------------------------------------------------------
--------------------------------------------------------------------------------------------------------------------------------------------
--------------------------------------------------------------------------------------------------------------------------------------------
---------------o-o--o-------------------------------------ooo------o-o------------------------o----o-o---------o----------------------------
----------o-------o---------oo------------------o-----ooo-----------------o----------------o-o-o----o-----------o---o-oo--ooo---------------
--------------o-o--o-o-o------o--------oo---------o------o----------o---------oooo---o-o--o-------o-----o---o-o----o-o--o----o--------------
-------o---o-o?-?-----o---oo-----------------o--------------------???-o---?-------oo----oo----------------o---S?X---------?S?S--------------
---------oSX----------------?X---oo-o-o-------XXSX-o----------o---------------------X-----XSX?-----------S---o------------------------------
--------o---------------------???----o-----XXS-----?S------------o-----XX?------------X--?-----------------?XS------------------------------
------S-S?------------------------------------------------------?X--------------------------------------------------------------------------
--------------XXXXXXXX--------------------------------XXXXXXXX----XXXX----XXXX----------------XXXXXXXX--------XXXXXXXX----XXXX--------------
XXXXXX----XXXXXXXXXXXX----XXXX----------------XXXX----XXXXXXXX----XXXX----XXXXXXXXXXXX----XXXXXXXXXXXXXXXX----XXXXXXXXXXXXXXXX--------------
XXXXXX----XXXXXXXXXXXXXXXXXXXXXXXX----XXXXXXXXXXXXXXXXXXXXXXXX----XXXXXXXXXXXXXXXXXXXXXXXXXXXXXXXXXXXXXXXXXXXXXXXXXXXXXXXXXXXX----XXXXXXXXXX
