--------------------------------------------------------------------------------------------------------------------------------------------
--------------------------------------------------------------------------------------------------------------------------------------------
--------------------------------------------------------------------------------------------------------------------------------------------
--------------------------------------------------------------------------------------------------------------------------------------------
----------------------------------------------o------------o-o--o-----------------o----------------------------------o----------------------
-------------------o-o------------------------------------o-o--o------o---oo-------oo--------------o-o-o------------------------------------
-------o--oo--------o--------o--------o--------oo------o----------------oo-----------o-------o----o--------ooo---------o--------------------
---------o----------------o-o---o---o--o------?XXSo---o----------S-o------??S--ooo?----o---oo---o---o----oo-----oo------o-oo----------------
--------o---o---o-------------o---------oo---------o-----------------oS?S?----o---------o---------------?X?-?X-----------o------------------
--------??XS??------------?XX--o--??--------------S???--------------SS----------------o--oS-??---o------------oo--------??---o--------------
--------------??S-------------SS?X-----------------------------------------------------?S?----??--------------?X?---------?-??--------------
------------------XXXX------------------------XXXX--------XXXXXXXX--------XXXX----XXXX----------------------------XXXX--------XXXXXXXXXXXXXX
------------------XXXX------------------------XXXX--------XXXXXXXX----XXXXXXXX----XXXX------------XXXXXXXXXXXX----XXXX--------XXXXXXXXXXXXXX
XXXXXXXXXXXXXX----XXXXXXXXXXXX----XXXXXXXXXXXXXXXXXXXXXXXXXXXXXXXXXXXXXXXXXXXX----XXXX----XXXX----XXXXXXXXXXXX----XXXXXXXX----XXXXXXXXXXXXXX
