--------------------------------------------------------------------------------------------------------------------------------------------
--------------------------------------------------------------------------------------------------------------------------------------------
--------------------------------------------------------------------------------------------------------------------------------------------
--------------------------------------------------------------------------------------------------------------------------------------------
--------o------------------------------------------------o------o-----------------------------------------oo--------------------------------
------o--o-o---------o----------o-------o--------------o---o--------------------o------------o--------o--o---o------------------------------
---------------o---oo----o-o-ooo------o--o------o-------o-----o----o--o----o-o-o-o-o-o------o---------------o--o---------o------------------
---------So-o-o---o----o--o------o-----o---------o--o-?S--o-oo-S----o--o------------------o------o-o------?S?Xo----o------------------------
-----------XX???--------o---o-S-XX---o-----o--o----o--------------o-----------------o----o?---------o----------X??---o-o--------------------
-------------------------?-??S----?-------o---?S?So---------------???S--?-XX?S-------X-o--------o-o--o------------------?So-oo--------------
------------------------------------------S-X?-------X--------------------------------?-?X----------------------------------??--------------
XXXXXXXXXX--------------------------------------------XXXX----XXXX------------XXXX------------------------XXXX------------------------------
XXXXXXXXXXXXXXXXXXXXXX--------XXXX----XXXX------------XXXXXXXXXXXX------------XXXX--------XXXX--------XXXXXXXXXXXX--------------------------
XXXXXXXXXXXXXXXXXXXXXXXXXXXXXXXXXXXXXXXXXX----XXXX----XXXXXXXXXXXXXXXXXXXXXXXXXXXXXXXX----XXXX--------XXXXXXXXXXXX----XXXX--------XXXXXXXXXX
