--------------------------------------------------------------------------------------------------------------------------------------------
--------------------------------------------------------------------------------------------------------------------------------------------
--------------------------------------------------------------------------------------------------------------------------------------------
--------------------------------------------------------------------------------------------------------------------------------------------
--------------------------------------------------------o-o--------oo---------ooo-----------------------------------o----o------------------
----------------------------oo------------o----------------o-o-------------------o------------o-o---------------------oo----o---------------
--------------------------------------oo-----o---o-o-o---------------o------o-----oo--------------o----o-------o-----o----------------------
--------oo-o----ooooo--oo------------o--o---------o---XS?------oo-XSXX-o-------------o-o------S-----o-----o--oo-o-------S--o-o--------------
------oo--o-o--------oo---?--?o-o--oo------X-?------o------------o----o------o--------o-o---o------o----------------------S?S?--------------
--------?----------------------?SXo-----------??X?X-?------------X------oo---------------oo----------?-X-X----------------------------------
----------???-?-------------------S--X------------------------------------------------?SSX-???------------??S?------------------------------
------------------------------------------------------XXXXXXXX----XXXX--------XXXX------------XXXX----------------XXXXXXXX----XXXX----------
--------------------------XXXX------------XXXX--------XXXXXXXX----XXXX--------XXXX------------XXXX----------------XXXXXXXXXXXXXXXXXXXXXXXXXX
XXXXXXXXXX----------------XXXXXXXX----XXXXXXXXXXXXXXXXXXXXXXXXXXXXXXXX----XXXXXXXXXXXX--------XXXXXXXXXXXX----XXXXXXXXXXXXXXXXXXXXXXXXXXXXXX
