--------------------------------------------------------------------------------------------------------------------------------------------
--------------------------------------------------------------------------------------------------------------------------------------------
--------------------------------------------------------------------------------------------------------------------------------------------
--------------------------------------------------------------------------------------------------------------------------------------------
--------------------o-----o-o------------------------------ooo--------------------------------o---------------------------------------------
------o-----------o-------------------------------oo----o----------o-o-----------------oo-----------------------o---------------------------
-------------------o---------o----------o--o-------------oo-----------------o-oo----------------o---o-o------oo-----o-----o-----------------
--------ooo-o----o-----o---S??----o-o-o---o-o--o------oo------o-----o---oo------o------?SXoo-------o-----Soo-----------o----o---------------
-------XX?------------o-o-----ooo------o--------oo?S--------------S-?Xo----o----------------------o---------o-X??---------------------------
----------S?-----------?-?----X----?--------??------------------oo--------X--------o-o-------o------------???------------oS-?X--------------
----------------------------------------------??-?------------?S-X-----??------------?----S??---------------------------X-------------------
------------------XXXX----XXXX----------------------------XXXX------------------------XXXX----XXXX----XXXX--------XXXX--------XXXX----------
XXXXXXXXXX--------XXXX----XXXX--------------------XXXXXXXXXXXX----XXXX----------------XXXX----XXXX----XXXX----XXXXXXXX--------XXXX----------
XXXXXXXXXXXXXXXXXXXXXXXXXXXXXXXXXXXXXXXXXXXXXX----XXXXXXXXXXXX----XXXX----XXXXXXXX----XXXX----XXXXXXXXXXXXXXXXXXXXXXXX----XXXXXXXXXXXXXXXXXX
