--------------------------------------------------------------------------------------------------------------------------------------------
--------------------------------------------------------------------------------------------------------------------------------------------
--------------------------------------------------------------------------------------------------------------------------------------------
--------------------------------------------------------------------------------------------------------------------------------------------
--------------------------------------------------o-------------------oo-----------------------o-----------------o-oooo---------------------
----------oo--------------------------------o------ooo--------------o---o-----oo---o----------o-o-------------o---------o----o--------------
------------o------o---------------o-o---o-----------------------o-o-o------o---o-o-o-oo--o------o--------o--o--o--------o--o---------------
--------oo-------o--o-------------o-o--oo--o-----o?--S--o--o----o-?S?X?SS?---o---o-?----oo-o-o----------------S---------X-o-----------------
----------X-S----------o-----o-o-o----o--------oo-----------o-o-----------X?----------?XX?-XS?-----oo---??-XS?------------?-XS--------------
-------o--------o-------o--oo-o-o-??---------------------oo--o---S--------------------------------------------------------------------------
------??XS-----X----------SX-?-X-?--------------X-----X-S-----------------------------------------------------------------------------------
--------------------------------------------------XXXX------------XXXXXXXX--------XXXX--------XXXX------------XXXXXXXXXXXX------------------
XXXXXX----XXXX----------------------------XXXX----XXXX------------XXXXXXXXXXXXXXXXXXXXXXXXXXXXXXXX----XXXXXXXXXXXXXXXXXXXXXXXX--------------
XXXXXX----XXXX----XXXX------------XXXXXXXXXXXX----XXXX--------XXXXXXXXXXXXXXXXXXXXXXXXXXXXXXXXXXXXXXXXXXXXXXXXXXXXXXXXXXXXXXXXXXXX--XXXXXXXX
