--------------------------------------------------------------------------------------------------------------------------------------------
--------------------------------------------------------------------------------------------------------------------------------------------
--------------------------------------------------------------------------------------------------------------------------------------------
--------------------------------------------------------------------------------------------------------------------------------------------
----------oo-------oo-------------o------------------------o-------------------------------------o----------o-------------------------------
-------o-o-----------o-------------o-o----------o-----------o--------------------------o-------o--o----------o------------oooo--------------
-------------o----o-----oo----o-----o------o---o----------o--o----o--o----o--o------------------o----o----o----------oo--o------------------
--------o-?SX---------o-----o--o--?----o---------o---o--o--------o--o--oo---o-----o-----oo--o-?--X-oo-------?Xo-o---o--oo--X??--------------
-------XXS-----------------o------------o------?SSo------o------------o----S---o-o--o-SSX?---o----S-----------X---o-------------------------
--------------------------o--oS-??----o--o----------o-?--------o-----?---o----o-o---------oo-------------o---------------S------------------
--------------------------XSX?--------------------?S?S-----------X----S???----------------??X-----------------------------------------------
----------XXXX----XXXX------------XXXX----XXXX------------XXXX--------------------------------XXXX--------XXXX------------XXXX--------------
XXXXXXXXXXXXXXXXXXXXXX------------XXXX----XXXXXXXX--------XXXX------------XXXX--------XXXX----XXXXXXXX----XXXXXXXX--------XXXXXXXX----------
XXXXXXXXXXXXXXXXXXXXXXXXXX----XXXXXXXX----XXXXXXXX----XXXXXXXX----XXXX----XXXX--------XXXX----XXXXXXXX----XXXXXXXXXXXXXXXXXXXXXXXXXXXXXXXXXX
