--------------------------------------------------------------------------------------------------------------------------------------------
--------------------------------------------------------------------------------------------------------------------------------------------
--------------------------------------------------------------------------------------------------------------------------------------------
--------------------------------------------------------------------------------------------------------------------------------------------
-----------------------o---o----o---------------------------------------------o-o-----------------------------------------------------------
----------ooo------o----o----o---------o----------------oo-----------------o-o------------o-------------o-----------------------------------
---------o----o---o-oo----o-------------o-----o---------------------o----------o--o-o-------oo---o----oo------------o-oooo-o-o--------------
------o------o-o-o-------??X-?XS?---------oo----o-o-o--?---oo--------ooo----o-----------oo?S?--o-----o----------o--------S--o---------------
-------o----?---o-----------------?-?X---------o-o---o-------o---?-???----XX---------o--------X---ooo-------o-o--ooo-o-----S?X--------------
--------?----------------------------------------?-----------------------o---------?-X---------------------o-o------------------------------
--------------------------------------------------?X?-----------------?-X?------------X-?-----------------?X-X?SX?--------------------------
----------------------XXXXXXXXXXXX--------------------XXXX--------------------XXXX--------XXXX------------------------XXXX------------------
----------XXXX----XXXXXXXXXXXXXXXXXXXXXXXXXXXX--------XXXX----XXXXXXXX----XXXXXXXX--------XXXXXXXX----XXXX------------XXXXXXXX--------------
XXXXXXXXXXXXXXXXXXXXXXXXXXXXXXXXXXXXXXXXXXXXXXXXXX----XXXX----XXXXXXXX----XXXXXXXXXXXX----XXXXXXXXXXXXXXXX--------XXXXXXXXXXXXXXXXXXXXXXXXXX
