--------------------------------------------------------------------------------------------------------------------------------------------
--------------------------------------------------------------------------------------------------------------------------------------------
--------------------------------------------------------------------------------------------------------------------------------------------
--------------------------------------------------------------------------------------------------------------------------------------------
------------------------------------o---------------------o-------------------------------------oo------------------------------------------
------------------------------oo-oo----------o--------oo-o-o-----------o-----------------------o-----------------------oo--o-o--------------
----------oo-----------o--------------o--o-o------o-----o---o-o------oo-----oo--------------o-----ooo-----o-o--oo-----o--oo-----------------
------oo--S?SX-o---o---------o----?-----o-o-o-------------------o-o------o----o--o--------o---X--------------oo-----------------------------
--------------o---o----?---SS???X-----------?X-o---o------------------X???-----oo-----o--------------o-o------SX?---------X?X---------------
--------o-------------------------------------o-ooX-??------------S-??----S--------------o-?XS---------?-??XXS------------------------------
-----------------------------------------------?-S-----------------------------------X-??---------------------------------------------------
XXXXXX----XXXX--------------------XXXX--------------------XXXX--------------------------------XXXX----------------------------XXXX--XXXXXXXX
XXXXXX----XXXX--------XXXXXXXXXXXXXXXXXXXXXXXX--------XXXXXXXXXXXX----XXXX--------------------XXXX------------XXXX----XXXXXXXXXXXX--XXXXXXXX
XXXXXX----XXXX----XXXXXXXXXXXXXXXXXXXXXXXXXXXX----XXXXXXXXXXXXXXXXXXXXXXXXXXXX------------XXXXXXXXXXXXXXXXXXXXXXXXXXXXXXXXXXXXXXXX--XXXXXXXX
