--------------------------------------------------------------------------------------------------------------------------------------------
--------------------------------------------------------------------------------------------------------------------------------------------
--------------------------------------------------------------------------------------------------------------------------------------------
--------------------------------------------------------------------------------------------------------------------------------------------
-----------------------------o------o--oo-------------------------------o--oo------o--------------o-----------------------------------------
------------------------o-------------o---------------------o----------o-----o-----------o-----------o--------------o---o---o---------------
--------------------------o-o------o---------o--------o---oo---oo-o-o-o-------------o-o------------oo-oo----------o----o---o-o--------------
------o---o-o-------------XX?-oo--??X---------o-ooo-oo--o----o-------o-??S-----oo-------o-ooo-----------o-------------o---o-----------------
---------o----o----o-o--?S------------------------???S---o---------o----------------------S-?S----------?----o------------?X-S--------------
-------oo-------o-o-o---------------------------------?-S--------?SS?X------------------------o-----------o-o-ooo---------------------------
-------S-SSS------------------XXSX------------S-S?---------------------------------------------X-----------X?-??S---------------------------
--------------------------XXXX----XXXXXXXX----------------------------XXXXXXXX----XXXX------------XXXX------------XXXX------------XXXXXXXXXX
XXXXXX----------------XXXXXXXX----XXXXXXXX--------XXXX----XXXX--------XXXXXXXX----XXXXXXXXXXXX----XXXXXXXX--------XXXXXXXXXXXX----XXXXXXXXXX
XXXXXX----------------XXXXXXXX----XXXXXXXXXXXX----XXXXXXXXXXXXXXXXXXXXXXXXXXXX----XXXXXXXXXXXX----XXXXXXXX--------XXXXXXXXXXXX----XXXXXXXXXX
