--------------------------------------------------------------------------------------------------------------------------------------------
--------------------------------------------------------------------------------------------------------------------------------------------
--------------------------------------------------------------------------------------------------------------------------------------------
--------------------------------------------------------------------------------------------------------------------------------------------
--------------o--o-o-o-----o------------o--------------------------------------------------------------o------------------------------------
------------------o-o-------o-o----------o--------------------o-o----------------------------------------o---o--------oo-o------------------
--------o--oo--o-------o-------oo-----oo-----------o-----------------o-------------------o--------o---------o--o----------------------------
--------------?-------------?----oo--o----------o---oo------o--o----o--o---o--------o--oo-o----------o-----o--o-ooo-----o-------------------
------o--o---o------------------X?-o-------oo----o?X-----o-o---S?So---o-o----o----oo--X?-X----------o-----XS-------o----?-oooo--------------
------X???SX?S--------------------?X?------------------oo----o----???XS-?--X?--o-o-----------------------------------o----------------------
---------------------------------------------XS?SX----X??---------------------------??----?S??----------------------------S-??--------------
--------------XXXXXXXX----XXXX--------XXXX------------------------------------------------------------XXXX------------------------XXXXXXXXXX
--------------XXXXXXXX----XXXXXXXX----XXXX--------XXXX--------XXXX--------------------XXXX------------XXXXXXXX--------XXXX----XXXXXXXXXXXXXX
XXXXXXXXXXXXXXXXXXXXXXXXXXXXXXXXXXXXXXXXXX--------XXXX--------XXXXXXXXXXXXXXXX--------XXXX----XXXXXXXXXXXXXXXXXXXX----XXXX----XXXXXXXXXXXXXX
