--------------------------------------------------------------------------------------------------------------------------------------------
--------------------------------------------------------------------------------------------------------------------------------------------
--------------------------------------------------------------------------------------------------------------------------------------------
--------------------------------------------------------------------------------------------------------------------------------------------
-----------------o---------------o--o-----------------------------------------------------oo-----------------oo-----------------------------
----------o-o---o-oo-------o--o-----------------------------------------oo----------------------------------------o----oo-------------------
-------o---o-oo-----o----o-----o-----o-------------o-o----ooo--------o---------o------------o--o---o----o--o---oo---------------------------
--------o-??XXXX-----o------oo--------------oo-o-oo------------o---o--o---o-o---o--o--oo-oSXSX----------?-X????-?---------oo----------------
---------o------------ooo-XSX----------o--------o---o-------------XS??-??-----o--o--o-S--?------o-o-o-----------------------o---------------
--------??---------------S------------o-oo---?----?S-So-------------------??-------???---------------------------------------S--------------
----------------------------------------------X?XX----S??X-----??S--------------------------------------------------------------------------
----------XXXXXXXX------------XXXXXXXX----------------------------------------------------XXXX--------XXXXXXXXXXXX----XXXX----XXXX--XXXXXXXX
----------XXXXXXXXXXXX----XXXXXXXXXXXX----------------------------XXXXXXXX------------XXXXXXXX--------XXXXXXXXXXXXXXXXXXXX----XXXX--XXXXXXXX
XXXXXXXXXXXXXXXXXXXXXXXXXXXXXXXXXXXXXX----XXXX----XXXX----XXXX----XXXXXXXXXXXXXXXXXXXXXXXXXXXXXXXXXXXXXXXXXXXXXXXXXXXXXXXXXXXXXXXX--XXXXXXXX
