--------------------------------------------------------------------------------------------------------------------------------------------
--------------------------------------------------------------------------------------------------------------------------------------------
--------------------------------------------------------------------------------------------------------------------------------------------
--------------------------------------------------------------------------------------------------------------------------------------------
--------------------------oo---------------------o-----------------o------------------o-----------------------------------o-----------------
--------o------o-------------o------------------o-----oo----------o--------------------------------------------------------o----------------
------oo--------------o----------o----------------oo-o--oo--oo-------o----------oo--o---oo----ooo----o-------o--------o--o--o---------------
---------oo--o------oo---?S-?--------o-oo--oo-S-XS--o-----o---oo--?X?--o-------o---o--?XS?o------o-o----ooo-o-oo-o--o--oo---XS--------------
-----------o---X---o----------oo---o----------------S-----------oo----------------o---------o-?-----o---------------------------------------
------------------o-----------????o---o--o----------------------------------------S--X----------------oo---?SS----------S-------------------
------------?----------------------X----------------------------??----S?SX----------------?------------???----X?S---------------------------
----------------------XXXXXXXX----------------XXXX----------------XXXX----------------XXXX--------------------------------XXXX--------------
XXXXXXXXXX----XXXX----XXXXXXXX------------XXXXXXXXXXXXXXXX--------XXXX----XXXXXXXX----XXXX----XXXX----------------XXXX----XXXX----XXXXXXXXXX
XXXXXXXXXX----XXXX----XXXXXXXXXXXX--------XXXXXXXXXXXXXXXXXXXX----XXXX----XXXXXXXXXXXXXXXX----XXXXXXXX----XXXX----XXXXXXXXXXXXXXXXXXXXXXXXXX
