--------------------------------------------------------------------------------------------------------------------------------------------
--------------------------------------------------------------------------------------------------------------------------------------------
--------------------------------------------------------------------------------------------------------------------------------------------
--------------------------------------------------------------------------------------------------------------------------------------------
---------o------------------------o-----------------o--------------o---------------------------ooo--------------o---------------------------
--------o----------------------o---o----o------------o-----oo-------oo-----------------oo--o-----------------o--------o-o-------------------
-------o-----------o-----o----------o--o-oo----ooooo---------oo--------o-o-----oo--------o--ooo---------------oo-------o-o------------------
-------SS--o--------o-oo--o---o---??X?------------S?SS-o-o-----o--?X---?X?-o--o---o-oo??--o---??--oo-oo-----??-?X---o-------oo--------------
----------???S--------------oo-?-S--------------------o-------------------o------o-o------?SX?------o-------------------S?o-----------------
-------------------------?-XX?--------------???XX?--------------------------oo------------------------------------o--------?-?--------------
------------------------------------------------------XS------------------------------------------------------------------------------------
XXXXXXXXXX------------------------XXXX------------XXXX------------XXXXXXXX------------XXXX----XXXX--------XXXXXXXX------------XXXX--XXXXXXXX
XXXXXXXXXXXXXX----------------XXXXXXXXXXXX--------XXXX----XXXX----XXXXXXXX------------XXXXXXXXXXXX----XXXXXXXXXXXX----XXXX----XXXX--XXXXXXXX
XXXXXXXXXXXXXX----XXXXXXXXXXXXXXXXXXXXXXXXXXXXXXXXXXXX----XXXXXXXXXXXXXXXX----XXXXXXXXXXXXXXXXXXXXXXXXXXXXXXXXXXXX----XXXXXXXXXXXX--XXXXXXXX
