--------------------------------------------------------------------------------------------------------------------------------------------
--------------------------------------------------------------------------------------------------------------------------------------------
--------------------------------------------------------------------------------------------------------------------------------------------
--------------------------------------------------------------------------------------------------------------------------------------------
------------------o--o--------------------------oo---------------------------o--------------------------------------o-----------------------
-------oo----------oo--o----o---------o-------o-------------o-------------o-------------------------------o--o-o----------------------------
----------------o-----o----o-o-o-------o-o--------------oooo------------o--o------ooo-----o------o---------o----ooo---o-oo------------------
---------ooooo-----------S----o---------o-----???---o-o--------------o-o-o?SXSo------------oo--X?X-oo-------o-o------------o----------------
------SX?X----o--o---------?-?--o----------o------o-------------------?-SX-----oo--------o--------o----o---?X?X-X------o--------------------
------------------------------?XSS??--------X?-----o-o---------o-o-o-------------o----o----X-S--------o------------------S------------------
----------?X??------------------------------------?SSS----------?-?-??--------S---------SX--------------------------------S??---------------
------------------XXXXXXXX--------------------XXXX------------------------XXXX----------------XXXX----------------XXXX------------XXXXXXXXXX
XXXXXXXXXX--------XXXXXXXXXXXX--------XXXX----XXXX----XXXXXXXX--------XXXXXXXX----------------XXXX--------XXXXXXXXXXXX--------XXXXXXXXXXXXXX
XXXXXXXXXX----XXXXXXXXXXXXXXXXXXXXXXXXXXXXXXXXXXXX----XXXXXXXX--------XXXXXXXX----XXXX----XXXXXXXXXXXX----XXXXXXXXXXXXXXXX----XXXXXXXXXXXXXX
