--------------------------------------------------------------------------------------------------------------------------------------------
--------------------------------------------------------------------------------------------------------------------------------------------
--------------------------------------------------------------------------------------------------------------------------------------------
--------------------------------------------------------------------------------------------------------------------------------------------
-------------------o------oo--oo-------oo----------------------------------------------------o--------------o-----------oo------------------
-----------o---o--o--o-------o--------o----o-----------------------------o-------------o-o-------------------o-o--o----o--------------------
----------------o---o-o-----o------------o---o--ooo--o------oo-o----o--o------------------o---------o---o-----o--o--------------------------
----------o--oXS-----------???S?-?------S--???-----------o--------oo--o-o-----o-----o---o--S?X-----o---o---SSS?X?S---o--?--o----------------
----------?XX----------o----------------------o---??XSo-o-oo----o----o-?-S--o---oo-o--?XX-------o-o------o--------X-------------------------
------o-oo------------------------o-----------???X-------?-----------X-------o----o-----------------------------------------oo--------------
---------S----------------------------------------------------------------S?---------S--------XS---------------------------XSS--------------
--------------XXXXXXXX----XXXXXXXX----XXXXXXXX--------------------------------------------XXXX------------XXXXXXXX----XXXX------------------
XXXXXX----XXXXXXXXXXXX----XXXXXXXX----XXXXXXXX----XXXX----------------XXXX------------XXXXXXXX------------XXXXXXXXXXXXXXXX----XXXX--XXXXXXXX
XXXXXX----XXXXXXXXXXXXXXXXXXXXXXXX----XXXXXXXXXXXXXXXXXXXXXXXXXXXXXXXXXXXX----XXXX----XXXXXXXX----XXXXXXXXXXXXXXXXXXXXXXXX----XXXX--XXXXXXXX
