--------------------------------------------------------------------------------------------------------------------------------------------
--------------------------------------------------------------------------------------------------------------------------------------------
--------------------------------------------------------------------------------------------------------------------------------------------
--------------------------------------------------------------------------------------------------------------------------------------------
----------------------o------------------------------o--o-------------oo-o------------------------------------------------------------------
-----------------o------------o-o------------o----o-----------------------ooo-o---------oo----o-oo---------o-----------o--------------------
------o---------o--------------------o-o--o-------------------oo----o----------o-o----o-----------o-oo-------o----------o-------------------
--------o---------oo-----?-----??-S-------?SS?---oSS?X?---------------?-?-------------SXSX--------------oo---------oooo-----o---------------
---------o----------o-----------------o-oo-----oo---------oooo-------o-------------o-o----o-oo-----o--o---S--?oo-o-------S-o-o--------------
--------S?oo---------o-----o-o----------------------------------X??--X-------------S?------o------------------------------------------------
----------???-------------?-?-----------------XSS?----------------------------------------S-------------??----?X?----------??---------------
----------------------XXXX----XXXXXXXX----XXXX----XXXXXXXX------------XXXX------------XXXX----XXXX----------------------------XXXXXXXXXXXXXX
--------------XXXX----XXXX----XXXXXXXX----XXXX----XXXXXXXX------------XXXXXXXXXXXX----XXXX----XXXX--------XXXX--------XXXX----XXXXXXXXXXXXXX
XXXXXXXXXX----XXXX----XXXX----XXXXXXXXXXXXXXXX----XXXXXXXX----XXXXXXXXXXXXXXXXXXXXXXXXXXXX----XXXXXXXX----XXXX----XXXXXXXX----XXXXXXXXXXXXXX
