--------------------------------------------------------------------------------------------------------------------------------------------
--------------------------------------------------------------------------------------------------------------------------------------------
--------------------------------------------------------------------------------------------------------------------------------------------
--------------------------------------------------------------------------------------------------------------------------------------------
---------------------------------o--o---------------------------------o--------o-----------------------------o-------------oo---------------
--------oo--------------------o----------------------o--------o-o--------o-------o----------------------o---o----o----o--o---o--------------
------------ooo-oo-o-------o---oo-o------oo--o----o-o----------o--o-o-----------o---------------o--oo----o----oo--o-------------------------
------S-SX-o--------o-oo----oo?--?S----o------o--o----S------o-S-X---o?S??--o---------------------o--------XSS-------o-o--?-SS--------------
----------o-------o------o------------o------S--o-SS?X-----o-------o------------------ooooo----o-----o--------S--S--------------------------
----------SS?-------------????-----------------o----------o-o------???-------o---------------o-X?-------------------------------------------
------------------------------------------------S?------------------------??--------?-----?--?----------------------------------------------
XXXXXXXXXX--------------------XXXXXXXX----------------XXXX----XXXX----XXXX----XXXX--------------------XXXXXXXX------------XXXXXXXX----------
XXXXXXXXXX----XXXX------------XXXXXXXX----XXXX----XXXXXXXX----XXXX----XXXX----XXXX--------------------XXXXXXXXXXXXXXXXXXXXXXXXXXXXXXXXXXXXXX
XXXXXXXXXXXXXXXXXXXXXXXXXXXXXXXXXXXXXXXXXXXXXX----XXXXXXXX----XXXXXXXXXXXX----XXXX----XXXX----XXXXXXXXXXXXXXXXXXXXXXXXXXXXXXXXXXXXXXXXXXXXXX
