--------------------------------------------------------------------------------------------------------------------------------------------
--------------------------------------------------------------------------------------------------------------------------------------------
--------------------------------------------------------------------------------------------------------------------------------------------
--------------------------------------------------------------------------------------------------------------------------------------------
----------------------------------------------------------------------o-o-----o--o-o--o--------------------------o----o---------------------
--------------------o----o---o-------------------------------------------------oo-o--o-----o-----o----------------------o-oo-o--------------
---------o--------oo-o-oo---o---------------------o--o-o-oooo------------o-o-o------o---oo-----------------o--ooo------o----o---------------
-------o--o---o------------o--o-o---o-o--------o----o--------o-----oooX--?o--------S----?-o---o--------------oXXX-o--o--?--?----------------
--------o---o---o-------X?---S-o--S?---oo-------o---------------------------o----------------?S?--oo--o-----o-------------------------------
------S-X?---o---------------------------o-----SX?X?-----------S?Xo--------?------------------------oo---o--SS------------------------------
----------S??-S---------------XX??--------------------------------S-------------------------------------------------------------------------
------------------XXXX------------------------------------------------XXXX----XXXXXXXXXXXX--------------------XXXX----XXXXXXXX----XXXXXXXXXX
------------------XXXXXXXXXXXX----XXXX--------------------------------XXXX----XXXXXXXXXXXXXXXXXXXX------------XXXX----XXXXXXXXXXXXXXXXXXXXXX
XXXXXXXXXX--------XXXXXXXXXXXX----XXXX----XXXXXXXXXXXXXXXXXXXXXXXX----XXXXXXXXXXXXXXXXXXXXXXXXXXXX--------XXXXXXXX----XXXXXXXXXXXXXXXXXXXXXX
