--------------------------------------------------------------------------------------------------------------------------------------------
--------------------------------------------------------------------------------------------------------------------------------------------
--------------------------------------------------------------------------------------------------------------------------------------------
--------------------------------------------------------------------------------------------------------------------------------------------
-------------------------------------o------------------------------------------------------------------------o-o---------------------------
-------o-oo--------------------o----------------o---------------------------------------ooo----------------------o--------------------------
--------o----o---o----o------------o-----------o-------oo---o--o--o------------o--oo--------o-----------o-----------------------------------
--------?S-???------oo-o------o-----------o--o----oo------oo----------o---------o----o-o------o-o-------------XS?------o----oo--------------
------------------oo----o-o--o?S-S-----oo------???---o---o---o--oo--o-------------------?-?-X----o---o-------------o------o-----------------
-------------------------X--o------------o--?-----X-?-?S---------XS-?--------------------------?X-o-------oo-o-------o--XX-?S---------------
---------------------X----S--X------------------------------------------?--S------------------------------X-?X------------------------------
XXXXXXXXXXXXXXXXXX----------------XXXX------------------------------------------------------------------------XXXX----------------XXXXXXXXXX
XXXXXXXXXXXXXXXXXX------------XXXXXXXX--------XXXX----------------------------XXXX----XXXXXXXX--------XXXX----XXXX----------------XXXXXXXXXX
XXXXXXXXXXXXXXXXXX----XXXX----XXXXXXXX----XXXXXXXXXXXXXXXXXXXXXXXXXXXX--------XXXXXXXXXXXXXXXXXXXX----XXXX----XXXX----XXXXXXXXXXXXXXXXXXXXXX
