--------------------------------------------------------------------------------------------------------------------------------------------
--------------------------------------------------------------------------------------------------------------------------------------------
--------------------------------------------------------------------------------------------------------------------------------------------
--------------------------------------------------------------------------------------------------------------------------------------------
------------------------------------------oo------------------o--------ooo-----------o------------------------------------------------------
------o---o--o------------o------o----oo-------o-----------------------------------------o----------------------------------o---------------
-------o-o-------oo-o--------ooo---o----oo--o---o---------------o-----o----------------------o-----------------o--oo-------o----------------
------------o------o---o----o---o------------So--o-oo-------o---?X--oo--?X---oo-o------o--oo----oooo-o--------o------o----o--o--------------
------S-?XS-X--o-----o----XXXSS???--oo----------??------o----o-----o------o------o-----??X???-------o--o-----o--------oo--X-?---------------
--------------?X------------------?---------------XSSSoo-o-o------S-?X---------o-----------------------?--o---?X?-------oo------------------
-------------------------------------------------------S--------------------------------------------------???X------------------------------
--------------------------------------XXXXXXXX----------------XXXX----XXXX--------XXXX------------------------------------------------------
XXXXXXXXXXXXXX------------XXXXXXXX----XXXXXXXXXXXX------------XXXX----XXXX--------XXXXXXXXXXXX--------------------XXXX----XXXXXXXX--XXXXXXXX
XXXXXXXXXXXXXXXXXXXXXX----XXXXXXXXXXXXXXXXXXXXXXXXXXXX--------XXXXXXXXXXXXXXXX----XXXXXXXXXXXXXXXXXXXXXXXX----XXXXXXXX----XXXXXXXX--XXXXXXXX
