--------------------------------------------------------------------------------------------------------------------------------------------
--------------------------------------------------------------------------------------------------------------------------------------------
--------------------------------------------------------------------------------------------------------------------------------------------
--------------------------------------------------------------------------------------------------------------------------------------------
------------------------------------------------------o--------------------o-o--------o-----------------------------------------------------
--------------------o------oo----------oo----------------o------------------o-----------oo---------------------------o-o-o------------------
------ooo-------------o---o--o--------------------------o-o-o-----o-------o--------oo-----ooo----------oo--o------------o-------------------
------S?-?------o--o-o-o--------ooo---o----------o------------------oo--o-??-?-oo-----S-?--S??-o-o-----------o--oo--------------------------
-----------o----------------??o----o---------?-o--ooo------o--oo-o-o--oo------o--o-----------------oo-----o---o---??S----S--o---------------
----------o--------------------o-----o------------?--?----------o-S?S?-??X--------------------?----------------o----------o--o--------------
----------??-??--?------------?S-?X------------S-?------------SS----------------------------------------------?SX?--------?XS---------------
XXXXXXXXXX--------------------------------------------XXXX----------------XXXX--------XXXXXXXX------------------------------------XXXXXXXXXX
XXXXXXXXXX--------XXXX----XXXX--------XXXXXXXX--------XXXX----------------XXXX----XXXXXXXXXXXX--------------------XXXXXXXX--------XXXXXXXXXX
XXXXXXXXXX--------XXXXXXXXXXXX--------XXXXXXXX----XXXXXXXXXXXX----XXXXXXXXXXXXXXXXXXXXXXXXXXXXXXXX----XXXXXXXX----XXXXXXXX--------XXXXXXXXXX
