--------------------------------------------------------------------------------------------------------------------------------------------
--------------------------------------------------------------------------------------------------------------------------------------------
--------------------------------------------------------------------------------------------------------------------------------------------
--------------------------------------------------------------------------------------------------------------------------------------------
--------------------------------------------------------o---o-oo-----------------------o----------------------------------------------------
--------------------o--------------------o--------o----o-o-------------------------------o-------------oo--o----------ooo-------------------
-------------oo-o-o--o----------o-----oo----o-o-------o---oo--------ooo--o-----o--------o----------ooo--------------------------------------
-----------o----------ooo----ooo--------o------o-o-ooo-----------X--------------oo-----XXSo-o----oo---------o-o--o---o--SS------------------
------oo-oo----o-o---------oo----o--------o--o--o-?-?X------------???S?-?-o--oo------------o---o--------X?XS??--------------o---------------
--------o---?X-?--------?-?-?XXXX?-----------X--?-----------------------------------------??X------------------o-----------o----------------
--------X?------------------------?S-------------------------------------------------?-------------------------??----------?-S--------------
------------------XXXX--------------------------------XXXXXXXXXXXX--------------------XXXX----------------------------XXXX----XXXX----------
------------------XXXX----------------XXXX--------XXXXXXXXXXXXXXXXXXXXXXXX------------XXXX--------XXXXXXXXXXXX--------XXXX----XXXXXXXXXXXXXX
XXXXXX----XXXXXXXXXXXXXXXXXXXXXXXX----XXXXXXXXXXXXXXXXXXXXXXXXXXXXXXXXXXXX----XXXX----XXXXXXXXXXXXXXXXXXXXXXXX--------XXXX----XXXXXXXXXXXXXX
