--------------------------------------------------------------------------------------------------------------------------------------------
--------------------------------------------------------------------------------------------------------------------------------------------
--------------------------------------------------------------------------------------------------------------------------------------------
--------------------------------------------------------------------------------------------------------------------------------------------
----------------------------------------------o-o-----------------------------------o-----------------------o-------------------------------
----------------------oo-----------------------o---o-o-ooo-----------o--------------------ooo----------o------ooo-o--------o----------------
-------------------------o------------o-------------o------o------o-o-------------oo-oo-oo---o--------o------o-----o------------------------
------o----o---o-o---o----o----------o---o--o---?------??S---oo----o------------o---?S-XX?----o-----o---o-??S?S??-?X--o--o--o---------------
---------oo--o-----o----S---ooo-o-------o----o----?XX-----o-o---------o-------o--o--------X???--oooo----------------------?S-X--------------
------XX?S--------------------------------o---------------?------------?-?---------------------------------------------o--------------------
--------------------------XX-X-?--------------------------------------------------------------??--X---------------------?X------------------
----------------------------------------------XXXX----XXXX------------------------XXXXXXXX----------------XXXXXXXXXXXX--------XXXX----------
----------------------XXXX--------------------XXXXXXXXXXXX----XXXXXXXX------------XXXXXXXXXXXX--------XXXXXXXXXXXXXXXX----XXXXXXXX----------
XXXXXXXXXX----XXXXXXXXXXXX--------XXXXXXXX----XXXXXXXXXXXXXXXXXXXXXXXXXXXX--------XXXXXXXXXXXX--------XXXXXXXXXXXXXXXX----XXXXXXXXXXXXXXXXXX
