--------------------------------------------------------------------------------------------------------------------------------------------
--------------------------------------------------------------------------------------------------------------------------------------------
--------------------------------------------------------------------------------------------------------------------------------------------
--------------------------------------------------------------------------------------------------------------------------------------------
----------------------o-o-----------------------------------------o-o---------------------ooo-----------------ooo---------------------------
-----------------o-oo--o-----------------------o----------o-oo-----------o-------o-----o-o----------oo-------------o-o----------------------
------o-oo---o------------------o---o-----o-oo--o------o-o-o---------o------------------o---------------------------o-o-----o---------------
-------S?Xoo------o----???---o-----------o-------o-o------------oo?-??o----o--ooo---------SX--o---oo-------oo-?-?-?-----oo-o----------------
----------???-----------------o---------o----XX--?--o---o------o-------?XS---------oo-?XXS-----o--------o----o---------o--SS??--------------
---------------------------oo-????----oo----------------X-------X-------------------------------------o-----------------XS------------------
--------------------------X?S?--------------------?S?S---------------------------------------------------?S???------------------------------
XXXXXXXXXX------------XXXX--------------------------------XXXX----XXXX--------------------XXXX----------------XXXXXXXX----------------------
XXXXXXXXXXXXXXXXXXXXXXXXXX--------XXXX----XXXXXXXX--------XXXX----XXXXXXXXXXXXXXXX----XXXXXXXX----XXXX--------XXXXXXXX----XXXXXXXX----------
XXXXXXXXXXXXXXXXXXXXXXXXXX----XXXXXXXX----XXXXXXXX----XXXXXXXXXXXXXXXXXXXXXXXXXXXXXXXXXXXXXXXXXXXXXXXX--------XXXXXXXXXXXXXXXXXXXXXXXXXXXXXX
