--------------------------------------------------------------------------------------------------------------------------------------------
--------------------------------------------------------------------------------------------------------------------------------------------
--------------------------------------------------------------------------------------------------------------------------------------------
--------------------------------------------------------------------------------------------------------------------------------------------
----------o----------------------------------------------------------------------------------------o-o----------------o--o------------------
-------------------------------------oo--o------------------------------o----o---------oo---o-------o------o-----------o--oo----------------
-----------o-o----o-o--o---------------o---------------------o---------o--------------o--o-------------------oo-----------------------------
----------??-X-----o-o--------o--oo-----o--o------oo---o-oo-o---o-----o--o-o---o-o-------?o---------------o--------------S--oo--------------
-------o--------------o--o-o-o--o--------------oo---oo--------o--o-o--?XX---X---o-o--o----X-X-------------XX?S-ooo--o-------?S--------------
---------o--------------?X?--X------------o--o??X--------------S----o--------------o---------------------?----S?X?-o-o----------------------
------?--X--------------------X--?----------XX----XSX?--------------S-----------------------------------------------------------------------
XXXXXX----XXXX------------------------------------------------------------------------XXXX----XXXXXXXX----------------XXXX----XXXXXXXXXXXXXX
XXXXXX----XXXX--------------------XXXXXXXX------------XXXXXXXX--------XXXXXXXX--------XXXXXXXXXXXXXXXX----XXXX--------XXXXXXXXXXXXXXXXXXXXXX
XXXXXX----XXXX----XXXXXXXXXXXX----XXXXXXXX----XXXX----XXXXXXXXXXXX----XXXXXXXXXXXX----XXXXXXXXXXXXXXXXXXXXXXXXXXXX----XXXXXXXXXXXXXXXXXXXXXX
