--------------------------------------------------------------------------------------------------------------------------------------------
--------------------------------------------------------------------------------------------------------------------------------------------
--------------------------------------------------------------------------------------------------------------------------------------------
--------------------------------------------------------------------------------------------------------------------------------------------
--------------------------------------------------------------------------------------------------------------------------------------------
-------o--o-o-----ooo------------------------o---o------------o------------------------------------------------------------o-o--------------
-----------o-oo------------------------ooo----o---o-------------------oo-o----o-oo-------o--------oo-oo-------------------o-----------------
---------o???---------o--o-oo-o---o-------------o--o--o--o-oo--o-o-o-----------o--o--o-----o-----------o-o--o-----o-----o---o---------------
-------S-?-------o---------------o-o-o---------SX?---o--X------SSX--o-------o------oo---o-o---------o--------oo--o-----o-o-SS---------------
--------------X??--------?o--o-o--?---------------XX??------------?-?X?X??S----------X-S-XS?S-S--------S??----?-----------------------------
--------------------------????-----------------------------------------------------------------------------SSS----------?-------------------
----------XXXX----XXXX----------------------------------------------------------------------------------------------------------------------
XXXXXXXXXXXXXX----XXXX----------------XXXXXXXXXXXX----XXXX----XXXX------------XXXX----------------------------------------XXXXXXXX--XXXXXXXX
XXXXXXXXXXXXXXXXXXXXXXXXXX--------XXXXXXXXXXXXXXXXXXXXXXXX----XXXXXXXXXXXXXXXXXXXXXXXXXXXXXXXXXXXXXXXXXXXX----XXXX--------XXXXXXXX--XXXXXXXX
