--------------------------------------------------------------------------------------------------------------------------------------------
--------------------------------------------------------------------------------------------------------------------------------------------
--------------------------------------------------------------------------------------------------------------------------------------------
--------------------------------------------------------------------------------------------------------------------------------------------
---------o----------------------------o-------ooo----------------------------------------------------------------o---------o----------------
------o---------oo---------------------o-o-------o------o-------o-o-oo-------------oo----o--------------------oo----------o--o--------------
--------o----o----o----------o----------o---------o--------oo-o--o----------o-o---------o-------o-----oo-----o----oo-o------o---------------
------X?S-o-o-------o--o--o---ooo-o-oo----o------?-o---o-oo--o----------o------o-oo-----------?S---o-o----ooo-??X-----oo---S?---------------
-----------o--?XS--o-o-----oo----------------o-----S-?S-----------?S---------o--o-------??o-------------oo----------------------------------
----------XX-?----------?SX?X-??--------------------------------------o--o-?-X----------------------o--????X-?----------oo------------------
----------------------------------------------------------------------S-SS-----------------S?----------------------------?------------------
XXXXXXXXXX----------------------------XXXX----XXXX--------------------------------------------XXXX------------XXXXXXXX----XXXX--------------
XXXXXXXXXX----XXXX----------------XXXXXXXX----XXXXXXXXXXXX----XXXXXXXX------------XXXXXXXX----XXXX------------XXXXXXXX----XXXXXXXX--XXXXXXXX
XXXXXXXXXXXXXXXXXXXXXXXXXXXXXXXXXXXXXXXXXX----XXXXXXXXXXXXXXXXXXXXXXXX----XXXXXXXXXXXXXXXX----XXXX----XXXXXXXXXXXXXXXX----XXXXXXXX--XXXXXXXX
