--------------------------------------------------------------------------------------------------------------------------------------------
--------------------------------------------------------------------------------------------------------------------------------------------
--------------------------------------------------------------------------------------------------------------------------------------------
--------------------------------------------------------------------------------------------------------------------------------------------
--------------------------------o-o----o--o----------------o---------o----oo-oo--------------------o-o--------------------------------------
--------o-ooo------o----------o------------------o----------oo----oo-----------ooo--------------------o-o-------------o--o------------------
-------o-------oooo-o----------o-o----o-oo--o--o--oo-o--------ooo---o-------------o-----o--o------o-o------o------o-o-----o--o--------------
---------o------------oo-o-----?---S--------??---------o-o-------o-?-Soo-o-----------o---oo---------SS------oooo-------oo--o----------------
------SS-XXX-S--------------oo-----------------SX---o-----------------?X?-------------X-SX---oo--o----X-???X?---o-------??S-X---------------
--------------?XX----------o----------------------X---o-o-------S--------------------?----S?X--?--------------------------------------------
---------------------------X?S--------------------------------------------------------------------------------X-----------------------------
------------------------------XXXXXXXXXXXXXXXX------------XXXX----XXXX----XXXXXXXX----------------XXXX------------------------XXXX----------
XXXXXXXXXXXXXX----XXXXXXXX----XXXXXXXXXXXXXXXXXXXX--------XXXX----XXXXXXXXXXXXXXXX----XXXX--------XXXXXXXXXXXX----XXXXXXXXXXXXXXXXXXXXXXXXXX
XXXXXXXXXXXXXXXXXXXXXXXXXX----XXXXXXXXXXXXXXXXXXXXXXXX----XXXXXXXXXXXXXXXXXXXXXXXXXXXXXXXXXXXXXXXXXXXXXXXXXXXX----XXXXXXXXXXXXXXXXXXXXXXXXXX
