--------------------------------------------------------------------------------------------------------------------------------------------
--------------------------------------------------------------------------------------------------------------------------------------------
--------------------------------------------------------------------------------------------------------------------------------------------
--------------------------------------------------------------------------------------------------------------------------------------------
-------------------------------------------------------o--oo-------------------------------------------o------------------------------------
-----------------------o--------o------oo-----------o-------o----o-oo-oo------ooo------o-o-------o--------oo-o---------o---o-o--------------
------------------o-o---------oo------------------o-----oo---o-------o------------------o-------------o-----o-ooooo--o----o-o---------------
---------oo--o-------oo-o---o-------------oo----------X-S?----o----XXX-----------o--------------o----o--?S---------oo----o-S-?--------------
--------o--------------?X?oo----X-o--o------oo----S-?S---------?-S----??X?---------------Xooo-XX--o-o-----?X-???X-------X-------------------
----------SXS?S--------------------oo----------o-o------------------------o------------------------o--------------X-------------------------
------??S?------------------S?--------------------------------------------X?---------------SX?----------------------------------------------
--------------------------------------XXXX------------XXXXXXXX----XXXX------------XXXX----------------XXXX----------------XXXXXXXX----------
----------------------XXXX----XXXX----XXXX--------XXXXXXXXXXXXXXXXXXXXXXXX----XXXXXXXXXXXX----XXXX----XXXXXXXXXXXX----XXXXXXXXXXXX----------
XXXXXX----XXXXXXXXXXXXXXXX----XXXX----XXXX--------XXXXXXXXXXXXXXXXXXXXXXXX----XXXXXXXXXXXX----XXXX----XXXXXXXXXXXXXXXXXXXXXXXXXXXXXXXXXXXXXX
