--------------------------------------------------------------------------------------------------------------------------------------------
--------------------------------------------------------------------------------------------------------------------------------------------
--------------------------------------------------------------------------------------------------------------------------------------------
--------------------------------------------------------------------------------------------------------------------------------------------
----------o---o---------------o-o--------------------o---------------------o-o---------------------o----------------------------------------
-----------oo---o-----------------o-----------ooo-oo----o-o-o---------o---o----------------------------------------o--o--oo-oo--------------
-----------------------o-o-----------o----oo-o--------o------o--o--------o--------oo--------------o-oo--------------------------------------
----------?X??----o----------o???X?----o----------X?X?---o-o-----------o---?--o------------o----o------ooo----oo-------o---o----------------
-------ooo---------ooo----?-XX-----------------XX?----X-------------o-XX?X-------o--??-oooo----o-------X?---------------?-?-S?--------------
------o-----------------?---------------oo----------------------S--------------oo-----?X-?----S------------o-o?X??--------------------------
-------------------------------------------------------------------XSS--------------------?S??--------------?S------------------------------
XXXXXX----XXXXXXXX------------XXXXXXXX------------XXXX--------------------XXXX--------------------XXXX--------------------------------------
XXXXXX----XXXXXXXX--------XXXXXXXXXXXX----XXXXXXXXXXXXXXXXXXXX--------XXXXXXXX----XXXX------------XXXXXXXX--------XXXXXXXXXXXX------XXXXXXXX
XXXXXX----XXXXXXXXXXXXXXXXXXXXXXXXXXXX----XXXXXXXXXXXXXXXXXXXXXXXX----XXXXXXXX----XXXXXXXX----XXXXXXXXXXXX----XXXXXXXXXXXXXXXX------XXXXXXXX
