--------------------------------------------------------------------------------------------------------------------------------------------
--------------------------------------------------------------------------------------------------------------------------------------------
--------------------------------------------------------------------------------------------------------------------------------------------
--------------------------------------------------------------------------------------------------------------------------------------------
--------------------------------------------------------------------------------------o-o----o---------o----o-------------------------------
----------o-----------o------------------------oo---------------------o-------ooo-o----o--ooo-----------o-o---------------------------------
-----------o------------oo-o----------o-o---------oo---o---------------oo--o-----o--o-----------o--------o---oo---o-------------------------
------oo--------o-o----o--o--oo---S--S-o-------------------o-o-----o--?X?X--o-------------?XS?---ooo----S??-S----------o--------------------
----------SXS?-----------?-------?--------o----???--o---o-----o-o-o--o-------o----------------------o-------------X---o------o--------------
--------oo---------ooo----X???-------------o------?XXX----o-o--o---?S-----------------------------------------?--S------??ooo---------------
------???-----------------------------------SX------------------?S--------------------------------------------------------XS??--------------
----------------------------------XXXX--------------------------------XXXX--------XXXXXXXXXXXX--------XXXXXXXX------------------------------
XXXXXX----XXXX--------XXXX----XXXXXXXXXXXX----XXXX--------------------XXXX----XXXXXXXXXXXXXXXX--------XXXXXXXX----XXXX--------XXXX----------
XXXXXX----XXXX--------XXXXXXXXXXXXXXXXXXXX----XXXXXXXXXXXX--------XXXXXXXXXXXXXXXXXXXXXXXXXXXXXXXXXXXXXXXXXXXXXXXXXXXXXXXX----XXXXXXXXXXXXXX
