--------------------------------------------------------------------------------------------------------------------------------------------
--------------------------------------------------------------------------------------------------------------------------------------------
--------------------------------------------------------------------------------------------------------------------------------------------
--------------------------------------------------------------------------------------------------------------------------------------------
----------o-o---------------------------------------------------o---------oo-o--------------o-------------oo--------------------------------
------o-------------------------------------------------------o-------------o-------o-----o---------o-------o--------o----------------------
-----------o-----------oo--o-oo-------o-o----------o-----------o------oo----------------o--o-oo------o-o-----o-----o-------o-o--------------
--------oo?SX?-------o---X-----o--o----o--o------oo-o---oo-------S-o-o----S-------o---o---X???----oo---------?oo--o---o-----o---------------
------S??-------o-o---------o-?-?X-------o---o--o---------oooo----o-o------------o-?-?---o------oo----o-o--------o-------o-?S---------------
--------------?--?--o-------X?---------------Xo---?S?-----------------SX??-----oo------S??----SX---------------??S-------S------------------
----------------------------------S-----------S?-?-----------------S-S-----------S----------------------------------------------------------
----------XXXX--------XXXX------------------------------------XXXX--------XXXX------------XXXX------------XXXX------------------------------
XXXXXXXXXXXXXX--------XXXX----XXXX--------------------XXXX----XXXX--------XXXX----XXXX----XXXX----XXXX----XXXX----XXXX----XXXX------XXXXXXXX
XXXXXXXXXXXXXXXXXX----XXXXXXXXXXXX----XXXXXXXX----XXXXXXXXXXXXXXXX----XXXXXXXX----XXXXXXXXXXXXXXXXXXXXXXXXXXXXXXXXXXXXXXXXXXXX------XXXXXXXX
