--------------------------------------------------------------------------------------------------------------------------------------------
--------------------------------------------------------------------------------------------------------------------------------------------
--------------------------------------------------------------------------------------------------------------------------------------------
--------------------------------------------------------------------------------------------------------------------------------------------
---------------o------o--o------------------------------------oo--------------------------------------o--o----o--o--------------------------
------o--o------o-----------------------------o------------------------o----------o----------o--------------------o-------------------------
-----------------o----------oo----o-o--------o-ooo----o-oo------o-o-ooo---o----------o--------o------o---------o-----o----------------------
------XS?Sooo-X?--------?SSX??o---------o--o--------------------X?X?SSXS?X---ooo-o------o-oo----o---o-?S?-o-o-SS----------------------------
----------XX-?-----ooo---------o-o---o-o-----?S?SX---o-------o------------?--------------oXX?X----oo---------------------o--oo--------------
------------------o-------------o-----o-----------o---X----oo-------------------o--------------------?-------o---------oo-------------------
------------------------------???------------------S?----------------------------------S------------------?-??----------S-?S??--------------
XXXXXXXXXX----XXXX----XXXXXXXX--------------------------------XXXXXXXXXXXX--------XXXX----------------XXXX----XXXX----------------XXXXXXXXXX
XXXXXXXXXXXXXXXXXX----XXXXXXXX------------XXXXXXXX------------XXXXXXXXXXXXXXXX----XXXX----XXXX--------XXXX----XXXXXXXX------------XXXXXXXXXX
XXXXXXXXXXXXXXXXXX----XXXXXXXX----XXXX----XXXXXXXX----XXXX----XXXXXXXXXXXXXXXX----XXXX----XXXXXXXXXXXXXXXX----XXXXXXXX--------XXXXXXXXXXXXXX
