--------------------------------------------------------------------------------------------------------------------------------------------
--------------------------------------------------------------------------------------------------------------------------------------------
--------------------------------------------------------------------------------------------------------------------------------------------
--------------------------------------------------------------------------------------------------------------------------------------------
-------------------o------------------o-------o---------oo------------------------------------------------oo-o------------------------------
----------o-------o-o-oo-o-o-----------o---------oo---o--------o-ooooo-----------------o--------o-----o---------------o--ooo----------------
---------------o-----o-------o-------o--oo---------ooo--------o-----------------------o-oo-----o----oo--o------------o-------o--------------
--------o--o-o----------o-o-o-o---S?S------------XX?-S???---o--??S?XX-oo-----o---------XXXooo-??S--o-------X??o----o---oo-------------------
----------?X-So-o-----------??------------o----------------o--------------o---o-o-----------------o------------oo-------?SX-?X--------------
------o--o-----?---------------o----------------------------------------oo-----o-o-oo-------------------------------------------------------
------???S--------------------SSXX------------------------------------SX?--X------X-??----X-??----------------X-?---------------------------
------------------XXXX------------XXXXXXXX----XXXXXXXXXXXX----XXXXXXXX----------------XXXX----XXXX--------XXXX--------------------XXXXXXXXXX
XXXXXX----XXXX----XXXXXXXXXXXX----XXXXXXXX----XXXXXXXXXXXX----XXXXXXXX----------------XXXX----XXXX----XXXXXXXX--------XXXXXXXX----XXXXXXXXXX
XXXXXX----XXXXXXXXXXXXXXXXXXXX----XXXXXXXX----XXXXXXXXXXXX----XXXXXXXX----------------XXXX----XXXXXXXXXXXXXXXX----XXXXXXXXXXXX----XXXXXXXXXX
