--------------------------------------------------------------------------------------------------------------------------------------------
--------------------------------------------------------------------------------------------------------------------------------------------
--------------------------------------------------------------------------------------------------------------------------------------------
--------------------------------------------------------------------------------------------------------------------------------------------
----------------------------------------oo--------------------------------------------------------oo----------------------------------------
---------o-------o-----o-o--o---------o----------------o----------o----------o----o--oo------------------------------o----------------------
-----------oo---o-----o-o-o----o-o---o-o----------o---o-oo--o--------o-----o-------oo--oooo---------oooo----o--o-oo------o------------------
-------oo-o---?-----o------o-o-----o--------o--------o----o----o-------oooo---o-oo-----???-----o-------S?S-o----------oo---ooo--------------
------??X---------o--o----??--o----S?S----------o---o------o------?S?S----??---o-----------o-----------------oo----------?o-----------------
----------S-XX-----o----------?X??---------o-----oS?SX------------------------------------S-X---------------X--X?---------------------------
----------------------------------------------?X-?---------------?----SX-?------------------------------------------------SS----------------
--------------XXXX--------------------XXXX--------------------------------------------XXXX--------XXXXXXXX--------------------XXXX----------
XXXXXXXXXX----XXXX----XXXXXXXX----XXXXXXXX------------XXXX--------XXXX----XXXX----XXXXXXXX--------XXXXXXXX--------XXXXXXXX----XXXX----------
XXXXXXXXXXXXXXXXXX----XXXXXXXXXXXXXXXXXXXX--------XXXXXXXXXXXX----XXXX----XXXX----XXXXXXXXXXXXXXXXXXXXXXXXXXXXXXXXXXXXXXXX----XXXXXXXXXXXXXX
