--------------------------------------------------------------------------------------------------------------------------------------------
--------------------------------------------------------------------------------------------------------------------------------------------
--------------------------------------------------------------------------------------------------------------------------------------------
--------------------------------------------------------------------------------------------------------------------------------------------
-----------o----------o--o----ooo-------------------------------------------------------------------------------------o--o------------------
------oo----------------o---------------o---------o-o--o-o-----------o----o-o-oo-oo------o-----------------------------o--------------------
--------ooo--oo-o-o----------------------------o-----o----o-oo----------oo-o-----------o------------o---o-oooo----------o--o----------------
----------SSX--------o----o---S--?o----o--o------o----o----o--o-----o------------------XX?--------oo-oo---X-XS-o--------??------------------
-------??S---------oo------o-o----------------X?SS-X?-X--?S----o--XX-Xoo------------------ooo--o--------------o--o--o-------oo--------------
----------------?------------------oo----------------------------o------------------------?S----------XXX?--------?--------SS?--------------
--------------------------SS?S----??-?------------------------------------------------------------------------?X----------------------------
----------XXXX--------XXXX----XXXX------------------------------------------------XXXXXXXX----------------XXXX--------XXXX------------------
XXXXXXXXXXXXXX--------XXXX----XXXX----XXXX----XXXXXXXXXXXXXXXX----XXXX----XXXXXXXXXXXXXXXX--------XXXX----XXXX--------XXXX----XXXX--XXXXXXXX
XXXXXXXXXXXXXXXXXXXXXXXXXX----XXXX----XXXXXXXXXXXXXXXXXXXXXXXX----XXXXXXXXXXXXXXXXXXXXXXXXXXXXXXXXXXXXXXXXXXXX----XXXXXXXXXXXXXXXX--XXXXXXXX
