--------------------------------------------------------------------------------------------------------------------------------------------
--------------------------------------------------------------------------------------------------------------------------------------------
--------------------------------------------------------------------------------------------------------------------------------------------
--------------------------------------------------------------------------------------------------------------------------------------------
-------o-o--------------------------------------o---------o---------------------o-------------------------------------oo--------------------
-----------------------------------------------o-----o--o---oo-------------------o-------------o-o-o-o------------------o-------------------
--------o--------------------o--------o----------ooo--oo-o-o----------o--o--o-oo--o-----o-o-o-----------o---o-------o----o------------------
-------?----o--------------------------oooo---X?S?------------o---o--oS-?--o-o-----------o----------o--?---o-o--o----------oo---------------
----------o--------oo-o-----o-o-o-----------o-----?S-----------oo--o------S--------o-oS--????-????--------o---oo-------------o--------------
-----------o--ooo---------X?-?---o-o-------o------------------?--?--o-------------------------------------X?S-------------o-----------------
----------??----X-------------?XXS?-------------------------------S-SX----------------------------------------?XS-----------??--------------
XXXXXXXXXX------------------------------------XXXX--------XXXX--------XXXX----XXXX--------------------XXXX--------XXXXXXXX----XXXX--XXXXXXXX
XXXXXXXXXX----------------------------XXXX----XXXXXXXXXXXXXXXX--------XXXXXXXXXXXX----XXXXXXXXXXXXXXXXXXXX--------XXXXXXXX----XXXX--XXXXXXXX
XXXXXXXXXX--------XXXXXXXXXXXX--------XXXX----XXXXXXXXXXXXXXXXXXXX----XXXXXXXXXXXXXXXXXXXXXXXXXXXXXXXXXXXXXXXX----XXXXXXXX----XXXX--XXXXXXXX
