--------------------------------------------------------------------------------------------------------------------------------------------
--------------------------------------------------------------------------------------------------------------------------------------------
--------------------------------------------------------------------------------------------------------------------------------------------
--------------------------------------------------------------------------------------------------------------------------------------------
--------------------------------------------------oo---o------------o-ooo-----o-o-----------------------------------------------------------
------o-------------o--o-------------------ooo----------------o--oo------o----------------------oo------------o-----------------------------
-------ooo-----------o-----------------oooo-----------o------o-----o-----------o----o---oo----o----------oo----o----------------------------
-------?SXo--------o----oo-----o-------------S---o?X-?---?--------?SX??XX--------------------o-----oo---o--ooo??-?o------o------------------
----------?S??-----------?-oo-o-o-o--oo-------o-----------oo---XX?--------o-oo----oo--o---o-o-----o---o--------------o-o--------------------
--------------------------X?-XS?-?-oo--------------------------------------------------X?X-----------o----???S----X-----X?-oo---------------
-----------------------------------------------X--------------------------XS--------------?S-?----------------------------??-?--------------
XXXXXXXXXX--------------------------------XXXX----XXXXXXXX--------XXXXXXXX----XXXX----------------------------XXXX----------------XXXXXXXXXX
XXXXXXXXXXXXXX----XXXXXXXX----------------XXXX----XXXXXXXX----XXXXXXXXXXXX----XXXX------------XXXX------------XXXX------------XXXXXXXXXXXXXX
XXXXXXXXXXXXXX----XXXXXXXXXXXXXXXX----XXXXXXXX----XXXXXXXXXXXXXXXXXXXXXXXX----XXXXXXXXXXXX----XXXX----XXXXXXXXXXXXXXXXXXXX----XXXXXXXXXXXXXX
