--------------------------------------------------------------------------------------------------------------------------------------------
--------------------------------------------------------------------------------------------------------------------------------------------
--------------------------------------------------------------------------------------------------------------------------------------------
--------------------------------------------------------------------------------------------------------------------------------------------
-------o--o-o--------------------------o-o-----------------------------------------------------------------ooo----o---o--o------------------
-----------------------o------o-------o-o---------o-o---------o-------------------o-o-----o--o----o--o---------oo------o--------------------
--------oo-o---o-o---o--------------------o----o---o-o-------o--------o----------------------------oo-----o---o---------o-------------------
---------?S?-?--o-ooo-------o--------------o-oo---?S?--oo-o-o---o-o--o-------o--------------o---------o--o--XS?X-S----------o---------------
---------------S--------XS-o--??X?-o--------o------------o-o--------o--o-o-----------------SSSo--o------------------------------------------
-----------------------------o----?X--------?XS??X----X-S-------------X-?-XX?-ooo-----oo-o-----?---------------------------o-o--------------
---------------------------?-S------------------------------------S?X?-------------------------------------------------------X--------------
XXXXXXXXXXXXXX------------------------XXXX--------XXXX----------------------------XXXX------------XXXX----XXXXXXXXXXXXXXXX--------XXXXXXXXXX
XXXXXXXXXXXXXXXXXX----XXXX----XXXX----XXXX--------XXXX--------XXXX----------------XXXX----XXXX----XXXXXXXXXXXXXXXXXXXXXXXX--------XXXXXXXXXX
XXXXXXXXXXXXXXXXXXXXXXXXXX----XXXXXXXXXXXXXXXXXXXXXXXXXXXXXXXXXXXX----XXXXXXXX----XXXX----XXXXXXXXXXXXXXXXXXXXXXXXXXXXXXXX----XXXXXXXXXXXXXX
