--------------------------------------------------------------------------------------------------------------------------------------------
--------------------------------------------------------------------------------------------------------------------------------------------
--------------------------------------------------------------------------------------------------------------------------------------------
--------------------------------------------------------------------------------------------------------------------------------------------
------------------------------------------o-------o-------ooo-----------------------------ooo-----oooo----o--o---------o-o------------------
---------------o--------------oo------------o-------o--------o------------------o------o-o---o--oo----------------------o-------------------
-----------------ooo---o---------o----o--o-------o-o-o------------o-----------oo-o----o-----------------------ooo-----o---------------------
--------------------o---------?-?X-ooo------S?--o--S----------------ooooo--o--------oo--S-SXSX??-S?---oo---S-S------oo---?o-o---------------
----------o-----------o-o---oo----o----oo-------------o--o-------?----?S-X---o-------------------------------------o-------o-o--------------
------o-o----o----------?S-o------------------X-?S----S-----------S?XX------------o---------------------------??----------------------------
--------?XS---------------S--S----??--------------------------------------?S-X--------------------------------------------?SS?--------------
------------------------------XXXX--------XXXX----XXXX----XXXX----------------XXXX----XXXXXXXXXXXXXXXX----XXXX--------XXXX----XXXXXXXXXXXXXX
XXXXXX--------XXXX------------XXXX--------XXXX----XXXX----XXXXXXXX----XXXX----XXXX----XXXXXXXXXXXXXXXX----XXXX--------XXXX----XXXXXXXXXXXXXX
XXXXXX--------XXXXXXXXXXXX----XXXX----XXXXXXXXXXXXXXXXXXXXXXXXXXXXXXXXXXXX----XXXX----XXXXXXXXXXXXXXXXXXXXXXXXXXXXXXXXXXXX----XXXXXXXXXXXXXX
