--------------------------------------------------------------------------------------------------------------------------------------------
--------------------------------------------------------------------------------------------------------------------------------------------
--------------------------------------------------------------------------------------------------------------------------------------------
--------------------------------------------------------------------------------------------------------------------------------------------
-------o------------------------------------------------------o----------o-----------o------------------------o-----------------------------
--------oo-ooo----------------------------oo----o-ooo-------------oo----o-----------o-------------oo-----------o----------------------------
--------------o----o--o----o--o-o------o----o-o--o---oo-o------o----o-oo-------o-----------o---------------o--------------------------------
-------?-?o----oo---oo---o--oo-------o-------oX-??-------oo-oo-------o--S?o-oo---o-X--ooo-o---------o--------oXS?---o------o-o--------------
------------?-?---o---------------o-----oo--------S?--------------XSS-----------o--------o---o--------o-----o------o-o---o------------------
---------------------------???-???-------------------------o------------------------------X?-----------XX-S?-X---------o--o-o---------------
----------------------------------?-XX------------------------------------------------???S------------------------------SS-XX---------------
XXXXXXXXXX------------------------------------XXXX------------XXXX----XXXX--------XXXX------------------------XXXX----------------XXXXXXXXXX
XXXXXXXXXXXXXXXXXX----XXXX----------------XXXXXXXXXXXX--------XXXXXXXXXXXXXXXX----XXXX--------XXXXXXXX--------XXXX------------XXXXXXXXXXXXXX
XXXXXXXXXXXXXXXXXXXXXXXXXXXXXXXXXX----XXXXXXXXXXXXXXXXXXXX----XXXXXXXXXXXXXXXXXXXXXXXX----XXXXXXXXXXXXXXXXXXXXXXXX------------XXXXXXXXXXXXXX
