--------------------------------------------------------------------------------------------------------------------------------------------
--------------------------------------------------------------------------------------------------------------------------------------------
--------------------------------------------------------------------------------------------------------------------------------------------
--------------------------------------------------------------------------------------------------------------------------------------------
--------------------------------o------oo------o-o---------------o--------------------------------------------------------------------------
---------------------o--------o--o---oo---------o-----o-----------------------------oo------------oo-o------------o-o---oo------------------
--------o----------o-----------o--oo-----o----o------o--ooo-o----------o-----o----o---------oo--oo--o------------------o--------------------
-----------o-----oo-o-----o--oSXX?-X------o----XS-o--------o-o???S--o-o-o--o--ooo--o--o---oo--SS--------o---o-o------------oo---------------
---------X----o--------o-o--o--------------oo------oo-S-?S-----------oX?X?-??----------oo---------------------------------------------------
----------------------o---------------------------S?SS------------oo---------------------oX???---------o-----o------------------------------
----------SXX?X----------X-?-S------------------------------------?--S------------------S?---------------X?-X?-S?-----------??--------------
------------------------------XXXXXXXXXXXX----XXXX------------XXXX----------------------------XXXX----------------XXXXXXXX------------------
XXXXXXXXXX--------XXXX--------XXXXXXXXXXXX----XXXX----XXXXXXXXXXXX----XXXXXXXXXXXXXXXX--------XXXXXXXX------------XXXXXXXX----XXXX--XXXXXXXX
XXXXXXXXXX--------XXXX--------XXXXXXXXXXXX----XXXXXXXXXXXXXXXXXXXX----XXXXXXXXXXXXXXXX----XXXXXXXXXXXX------------XXXXXXXX----XXXX--XXXXXXXX
