--------------------------------------------------------------------------------------------------------------------------------------------
--------------------------------------------------------------------------------------------------------------------------------------------
--------------------------------------------------------------------------------------------------------------------------------------------
--------------------------------------------------------------------------------------------------------------------------------------------
------------o-------------------------------------------------------------------o----------------------o--------o---------------------------
------------------ooo----------oo-------------o-o--o------ooo------ooo--------o-----o-------oo----------o-o-o--------------ooo--------------
--------o-o-------------------o-----------oo--------oo---o---o------------o------------o---o---o--o-----------oo--------o-------------------
------oo-o-???---o----o--o----S?XS----oo-------o-oXS----o------ooo-X??----?-------------o-o-------------?X---o???--------o------------------
-----------------------------o------o---o---oo-X??------------S--?----o-------------------?-X-o----oo-----SS?S--------oo----SX--------------
-------XXX-----o--------S---o--------o---o----------------------------X-?X--------------------XX------------------??-----?------------------
--------------S-----------S-------?---------------------------------------------------------------------------------------------------------
----------XXXX----------------XXXX----------------XXXX----XXXX----XXXX----XXXXXXXXXXXX----------------XXXX----XXXX------------XXXX----------
----------XXXX----XXXX--------XXXX------------XXXXXXXXXXXXXXXXXXXXXXXX----XXXXXXXXXXXX----XXXX--------XXXXXXXXXXXX--------XXXXXXXXXXXXXXXXXX
XXXXXXXXXXXXXX----XXXXXXXX----XXXX--------XXXXXXXXXXXXXXXXXXXXXXXXXXXXXXXXXXXXXXXXXXXXXXXXXXXXXXXXXXXXXXXXXXXXXXXXXXXXXXXXXXXXXXXXXXXXXXXXXX
