--------------------------------------------------------------------------------------------------------------------------------------------
--------------------------------------------------------------------------------------------------------------------------------------------
--------------------------------------------------------------------------------------------------------------------------------------------
--------------------------------------------------------------------------------------------------------------------------------------------
------------------------------------------------o-----------oo-----o--o---------------------------------------------------------------------
-------oo------o--------------o-----o-----o------o--------o----------o----o--o-----------------o-o-o----------------------------------------
------o--o-------oooo----------o-----------o--o----o-------o-----------o-o-o---oo----------o------o--o----o----------o-----oo---------------
----------o---o-----------o-----o--o-o-o---XS??S??-----o--------o-XS??SS-?--o---------------o---o---o----o-----oo-----oo--o--o--------------
--------S?----SS-??-----------X?SXS---o--o--------o------------o-----------------o----o-o--------------------o----o-------------------------
------------o----------o----oo--------------------??X----------??--------------------S---o???S---------------Xo--o??----ooS?----------------
----------XSXX-----------??XX?--------------------------------------------------------X-S?--------------------X?SX------X-------------------
------------------------------------------XXXXXXXX--------XXXX----XXXXXXXX------------------------------------------------------------------
XXXXXXXXXX----XXXXXXXX--------XXXXXXXX----XXXXXXXX----XXXXXXXX----XXXXXXXXXXXX----------------XXXXXXXX----------------------------XXXXXXXXXX
XXXXXXXXXX----XXXXXXXX--------XXXXXXXXXXXXXXXXXXXXXXXXXXXXXXXXXXXXXXXXXXXXXXXXXXXXXXXX----XXXXXXXXXXXXXXXXXXXX----XXXX----XXXX----XXXXXXXXXX
