--------------------------------------------------------------------------------------------------------------------------------------------
--------------------------------------------------------------------------------------------------------------------------------------------
--------------------------------------------------------------------------------------------------------------------------------------------
--------------------------------------------------------------------------------------------------------------------------------------------
----------------------------------------------------------------------o---------------------------------------------------------------------
---------o--------ooo--------o---------o-----o----------------------------------------o---------------------------oo-o----o--o--------------
-------o--oo-------------------------------o-------o------oo-----------ooo-------------oo-----------------o-o-------------------------------
--------o---o----o---oo---o-o---------o-oo--o--o----o-oo------oo--o---SX?----------o-----o-o---------o-------ooo----o---o--??---------------
-------?S------o---------oSS?-o--o----------S?--ooo--o---o--oo-----o------??--o-oo------SS----??---oo------o-----oS---o---------------------
----------?-?Xo--------o--------o----o--------??SS?SX---o------------o---------o--o-------o--o--------------??---------o--------------------
--------------???-------------??S-S--?----------------------------??-?--------------------X-S?-----------------?-?------??------------------
----------------------------------------------------------------------XXXX------------------------------------------------XXXX------XXXXXXXX
XXXXXXXXXX--------XXXX----XXXX--------XXXXXXXX----------------XXXX----XXXXXXXX--------XXXX----XXXX----------------XXXX----XXXX------XXXXXXXX
XXXXXXXXXXXXXX----XXXX----XXXX--------XXXXXXXXXXXXXXXX----XXXXXXXX----XXXXXXXX--------XXXX----XXXX--------XXXX----XXXX----XXXX------XXXXXXXX
