--------------------------------------------------------------------------------------------------------------------------------------------
--------------------------------------------------------------------------------------------------------------------------------------------
--------------------------------------------------------------------------------------------------------------------------------------------
--------------------------------------------------------------------------------------------------------------------------------------------
--------------------------------------------------o-o-----------------------o---------------------oo------------o----o----------------------
---------------------------oo------------------------------------------o--o--o------------o---------o-------------o-o-----------------------
--------oo------------o-oo---o-----oo--o-----o-----o------oooo-----o-o----------------ooo-------------------o-oo------o--o------------------
-----------o------o-oo-o-------oo----o--o--?X---o-?S??oo-o----------o-o-----------o------o-oo---o-----o------o?--S-----o--ooo---------------
----------o--oo-oo-o--?-?-?XSS----o------o-----o------------------?S????S-----o--o-----X---???---------------------------?-?-X--------------
-------X?---------------------o-------------------------------o--o-------------oo----o---------o--------oo??X?------------------------------
----------???S-----------------??-------------X?XS------------?---------------------?S--------?----------S----------------------------------
------------------------------------------XXXX----XXXX----XXXX------------XXXX--------------------XXXX--------XXXXXXXX----------------------
----------------------XXXXXXXX------------XXXX----XXXXXXXXXXXX----XXXXXXXXXXXX--------XXXXXXXX----XXXX--------XXXXXXXXXXXXXXXX--------------
XXXXXXXXXX----XXXX----XXXXXXXX----XXXXXXXXXXXX----XXXXXXXXXXXX----XXXXXXXXXXXX--------XXXXXXXX----XXXX----XXXXXXXXXXXXXXXXXXXX----XXXXXXXXXX
