--------------------------------------------------------------------------------------------------------------------------------------------
--------------------------------------------------------------------------------------------------------------------------------------------
--------------------------------------------------------------------------------------------------------------------------------------------
--------------------------------------------------------------------------------------------------------------------------------------------
-------------------------------------------------------------------o-----o----------------oo-o------------o-o-------------------------------
------------oo----------------------------------oooo------o---------o---o--------o----------o--o------o-oo-o-o----------o-------------------
-------o---------o-----------oo---------------o-------------o--------oo--------o--------oo--------------------o----------o------------------
--------oooo--X-X?--oo---------oo-oo------oo----------o----o-o-oo---S-??----ooo-o---ooo---XSSS----o-oo-o--?-X--o----o--o--------------------
------SS???SSS-----o--o--ooo-----------ooo-----XX?XSS?-o-o---------------------?---o---o-----------o---?SX--------------S--oo---------------
--------------------------------?---ooo-----------------------------------XX??--------SS?X--------------------XS----------o-----------------
-------------------------------------------S-S--------?--S-----------------------------------------------------------------?SS--------------
--------------XXXX------------------------------------------------XXXXXXXX----------------XXXX------------XXXX------------------------------
XXXXXXXXXXXXXXXXXX----------------------------XXXXXXXX----XXXXXXXXXXXXXXXX----XXXX--------XXXXXXXX----XXXXXXXX--------XXXX----XXXX----------
XXXXXXXXXXXXXXXXXX--------XXXXXXXX------------XXXXXXXX----XXXXXXXXXXXXXXXXXXXXXXXX----XXXXXXXXXXXXXXXXXXXXXXXXXXXX----XXXX----XXXXXXXXXXXXXX
