--------------------------------------------------------------------------------------------------------------------------------------------
--------------------------------------------------------------------------------------------------------------------------------------------
--------------------------------------------------------------------------------------------------------------------------------------------
--------------------------------------------------------------------------------------------------------------------------------------------
--------------------------------------o-o-------------------------------------------oo---o-------------------oo-----------------------------
-------o---------------------------------o--------o-------------oo-----o----------oo----o--o-o---o--o----------o-o---------o----------------
--------------------------------oo-ooo-o---------o-o------o----o------o----o----o-----oo--o----o--oo--o---o-------oo--------o---------------
--------oo-o--SX---o-o-----ooo-----------------------ooo----oo--??------o-?---oo--S?S?S?-X--------------o---SSSX?---------o-----------------
------S?SXo-o-------o-oo------oo---------------o--S-?---o--o-------o-o?SSS-------o--------S?------------------------------S?-?--------------
------------------o-----ooo---S-?S??---------oXXSX------------------o-------------------------------------------------ooo-------------------
----------?XSS-------------XXS-------------XX---------------------XXX?--------------------------------------------------S-------------------
--------------XXXX--------------------XXXX--------------------XXXX--------XXXX----XXXXXXXX--------XXXX----XXXXXXXXXXXX----------------------
XXXXXXXXXX----XXXX--------------------XXXX--------XXXX--------XXXX----XXXXXXXX----XXXXXXXXXXXXXXXXXXXXXXXXXXXXXXXXXXXX----XXXXXXXX----------
XXXXXXXXXX----XXXX------------XXXXXXXXXXXX----XXXXXXXXXXXXXXXXXXXX----XXXXXXXXXXXXXXXXXXXXXXXXXXXXXXXXXXXXXXXXXXXXXXXX----XXXXXXXXXXXXXXXXXX
