--------------------------------------------------------------------------------------------------------------------------------------------
--------------------------------------------------------------------------------------------------------------------------------------------
--------------------------------------------------------------------------------------------------------------------------------------------
--------------------------------------------------------------------------------------------------------------------------------------------
---------------------------------------------------------------------------------o-------------------------------------oo-------------------
------o---o-o-------------o--------------------------o------------------------o----------------o--o----oo-------------o---------------------
--------o--o----------o-o--o--o-o---o-------------ooo---oooo----------o-o-------o------ooo----------o----o-o---------o---o-o----------------
-------o-o-SX--o----o--o-----o---------------o--o-----------o--oo---o----------------------o----o--o-oo------o---oo-----?X------------------
------SS??---------o-----o--SS??-?-----oo---o----oXX---------o-------o-o---o------oo----------??S--------?-----------------XS---------------
------------------o--o--S?---------------o?-S-?SS?-----------------X?S??S?------------???So---------------??X?ooo---------------------------
---------------------------------------------------------------?S?------------------------??-------------------X?X--------------------------
----------XXXX--------------------XXXX----------------------------------------XXXX------------------------------------XXXX------------------
XXXXXXXXXXXXXX------------XXXXXXXXXXXX------------XXXXXXXX--------------------XXXX------------XXXXXXXXXXXX--------XXXXXXXXXXXX--------------
XXXXXXXXXXXXXX--------XXXXXXXXXXXXXXXX----XXXXXXXXXXXXXXXXXXXX----XXXXXXXXXXXXXXXXXXXXXXXX----XXXXXXXXXXXXXXXX----XXXXXXXXXXXX----XXXXXXXXXX
