--------------------------------------------------------------------------------------------------------------------------------------------
--------------------------------------------------------------------------------------------------------------------------------------------
--------------------------------------------------------------------------------------------------------------------------------------------
--------------------------------------------------------------------------------------------------------------------------------------------
-----------------------------------------------------------------------o-----------------o--------------------------------------------------
---------o-----oo--------o-----------------------oo-oo----oo------------------o---------o--------o-----o------------------------------------
-------o---------o------------------o--------------o--------o--o----o-o----o----o-----oo--o----o------o-------o-o------o--------------------
------S???oooo-----oooo---o-o---o-oo---o---o------XX?So-o-------------??XX--oo-------oSSSX---------o----o-o-o-SX?-------ooo-----------------
----------------------SSXX---ooo-o---------------S------------o-o-o--o------?-------o------o---------o-S--------------o-----o---------------
-------------S----o--------o----------o---------------X-?---------S-SS--------------------?SS-----o-o------o-o----------X--o----------------
---------------------?----?-?????----------------------------------------------------?--------------------SXSS------------X--?--------------
XXXXXXXXXX----------------------------------------XXXX----XXXX--------XXXX------------XXXX--------------------XXXX------------XXXX----------
XXXXXXXXXX----XXXX----XXXX--------XXXX----XXXXXXXXXXXX----XXXX--------XXXXXXXXXXXX----XXXX----XXXX----XXXX----XXXX------------XXXX----------
XXXXXXXXXXXXXXXXXX----XXXX--------XXXX----XXXXXXXXXXXXXXXXXXXXXXXXXXXXXXXXXXXXXXXX----XXXXXXXXXXXX----XXXX----XXXXXXXXXXXX----XXXXXXXXXXXXXX
