--------------------------------------------------------------------------------------------------------------------------------------------
--------------------------------------------------------------------------------------------------------------------------------------------
--------------------------------------------------------------------------------------------------------------------------------------------
--------------------------------------------------------------------------------------------------------------------------------------------
---------o---------------------------o-----------------------------------------------------o--------o----------o----------------------------
------------------o--o--------------o----oo-------------------------o-----------------o--oo--o--------o----------o-----oo-------------------
--------o--ooo------o-oo-----o---------oo---------------o------------o---------o------------o------o-o---o-o-oo-------o---------------------
-------------------o-----o----o-oo-----------o----o-o-oo---o-o-o---o--o-------o-----------SXXS---------o------?X?--o-o--?S-ooo--------------
---------------------------X---S?----------???---o-o-o---o--o-o---???S---o?-----oo--XX-S?X------o--------S?S??------------o-----------------
-----------?S?--o--------X---------------------oo---------o-----o------oo------------------------o------------------------------------------
--------------S-?-----------------------------X?-SS?------------------SX-X-------------------------------------------------?-?--------------
XXXXXXXXXX------------------------XXXXXXXX------------------------------------------------XXXX----XXXX--------XXXX----XXXX------------------
XXXXXXXXXX--------XXXX----XXXXXXXXXXXXXXXXXXXX--------------------XXXX----XXXX----XXXXXXXXXXXX----XXXXXXXXXXXXXXXX----XXXX----XXXX----------
XXXXXXXXXXXXXX----XXXXXXXXXXXXXXXXXXXXXXXXXXXX--------XXXX--------XXXX----XXXXXXXXXXXXXXXXXXXX----XXXXXXXXXXXXXXXX----XXXX----XXXXXXXXXXXXXX
