--------------------------------------------------------------------------------------------------------------------------------------------
--------------------------------------------------------------------------------------------------------------------------------------------
--------------------------------------------------------------------------------------------------------------------------------------------
--------------------------------------------------------------------------------------------------------------------------------------------
---------------------------o-o----------------o--------o-----------------o------------oo-------o----------oo--o-o---------------------------
-----------------------------------------------o----oo----------------o-----o--ooo-------o------------------oo---o------o-------------------
------------------------------o-------ooo----o--oooo--------------------------------o---o-o--------------------o--o--o-o-ooo----------------
---------oo-o--oo--o-----o?X??-oo--------o----S-?-----S---ooooo--oo---X?-S-----------o?S?S----------o-o--o--???S?---o-o-----o---------------
--------o-----------oo--------XX-?-ooo----o--------S?---------------------S-----------------oo----o--o-o----------------??------------------
-------o---o-----o----------------XX--------X?----------------------oo--------------??----X???-----o--------------SX-------X??--------------
-------X-?S??SXS?---------------------------------------------------SX----------------------------------------------------------------------
XXXXXX--------------------XXXX----------------XXXX----XXXX------------XXXX------------XXXX----XXXX--------XXXXXXXX----------------XXXXXXXXXX
XXXXXX--------------------XXXXXXXX------------XXXXXXXXXXXXXXXX--------XXXXXXXXXXXX----XXXX----XXXX--------XXXXXXXX----XXXX--------XXXXXXXXXX
XXXXXX--------------------XXXXXXXXXXXXXXXXXXXXXXXXXXXXXXXXXXXX--------XXXXXXXXXXXXXXXXXXXXXXXXXXXX--------XXXXXXXXXXXXXXXXXXXXXXXXXXXXXXXXXX
