--------------------------------------------------------------------------------------------------------------------------------------------
--------------------------------------------------------------------------------------------------------------------------------------------
--------------------------------------------------------------------------------------------------------------------------------------------
--------------------------------------------------------------------------------------------------------------------------------------------
--------------------------oo-o---o----------o-o--o---------o-o------------------------------------------------------------------------------
----------o--------ooo---------o-------------o-o----------------------o----------------o--------------oo--o--oo-o------oo-------------------
-----------o-o----o---oo------o-o--o------oo-------------o--o---o-------o-----oo---o----o--oo---------------o--------o----------------------
--------oo--o---o---------??--X?-------o-o---??XSS-------------o----o------------oo---o-------o----o-------o--SS?--------ooo----------------
----------???----o------------------o-------------o---------------o---??-S----------S-X?-?o--o--o---oo--?X?S??----------S?--o---------------
------?X??----?-----------------------------------XX?-SX-----------o-o----S------S--------?-??----------------------------------------------
---------------------------------------------------------------------?----------------------------------------------------?-??--------------
------------------XXXX----XXXXXXXX--------XXXXXXXX--------XXXX------------------------------------------------XXXX--------------------------
----------XXXX----XXXX----XXXXXXXX----XXXXXXXXXXXX--------XXXX--------XXXX--------XXXXXXXX------------XXXXXXXXXXXXXXXXXXXX----XXXXXXXXXXXXXX
XXXXXXXXXXXXXXXXXXXXXXXXXXXXXXXXXXXXXXXXXXXXXXXXXXXXXXXXXXXXXXXXXX----XXXXXXXXXXXXXXXXXXXXXXXXXXXXXXXXXXXXXXXXXXXXXXXXXXXX----XXXXXXXXXXXXXX
