--------------------------------------------------------------------------------------------------------------------------------------------
--------------------------------------------------------------------------------------------------------------------------------------------
--------------------------------------------------------------------------------------------------------------------------------------------
--------------------------------------------------------------------------------------------------------------------------------------------
-------------------------o----o---------------------o--------------o-o-------------------o------------oo---------------oo-------------------
---------o---------------------------------o--o--oo-----oo------------oooo-----oo--------------oo---------ooo-oo------o---------------------
--------o---o--oo-o-o----------o------oo-o--oo-o---o--oo----------o---------------------o---o-----o--o--o----o-----------o-o----------------
-------------o---o---o-SX?----X-?Xo--o--o-o----X-X?-?X----oo--o---S-?---------o-------?-X?o---?-------?X-????-------o-----------------------
--------??oo--o-------------oo------------------------?-----o---------?X-----------o---------o-----oo---------?----o------o-o---------------
----------S???S-----------X?-------X-------------------------o----------------------o-----?-S?--------------------o-------?SX?--------------
---------------------------------------------------------------?X-----------------?XSS------------------------------------------------------
----------------------XXXX----XXXX------------XXXXXXXX------------XXXX----------------XXXX----XXXX----XXXXXXXX--------XXXX----XXXX----------
XXXXXXXXXX--------XXXXXXXX----XXXX----XXXXXXXXXXXXXXXXXXXX--------XXXXXXXXXXXXXXXX----XXXX----XXXX----XXXXXXXXXXXX----XXXX----XXXX----------
XXXXXXXXXXXXXXXXXXXXXXXXXXXXXXXXXXXXXXXXXXXXXXXXXXXXXXXXXX--------XXXXXXXXXXXXXXXX----XXXXXXXXXXXXXXXXXXXXXXXXXXXX----XXXXXXXXXXXXXXXXXXXXXX
