--------------------------------------------------------------------------------------------------------------------------------------------
--------------------------------------------------------------------------------------------------------------------------------------------
--------------------------------------------------------------------------------------------------------------------------------------------
--------------------------------------------------------------------------------------------------------------------------------------------
-------------------------o------oo------------o-----------o-oo-----oo-----oo-o-----------------o-------------oo-o---------------------------
-------------------oo----------o-------oo-------oo-------------o------ooo------------------oo-o--ooo-------------o--------------------------
-------o-o-----------oo-----ooo-------------o------------o-o---------o---o----------oo--------------o-o--oo-o--o----o-----------------------
--------o--o------o-------o---S-?----o----oo--XS?X----oo-----------?-?----S------o-o------o---?------o-----?X??S?---------------------------
----------o-o--o-----------------------------?----oo-o?X--------------?X-?----o-o-o---oooo?SS?-----S----------------------o-oo--------------
------??X?-------o---------??X---------------------?S--------------------------o--SSS---------------------------------oo-o-o----------------
-----------X-X------------------------------------------------------------------------??XS------------------------------?---??--------------
----------------------XXXX----XXXX----XXXX----XXXX--------XXXX----XXXX----XXXX----------------XXXX--------XXXXXXXX--------------------------
------------------XXXXXXXX----XXXX----XXXXXXXXXXXX----XXXXXXXXXXXXXXXXXXXXXXXX------------XXXXXXXXXXXX----XXXXXXXX--------------------------
XXXXXXXXXX--------XXXXXXXXXXXXXXXXXXXXXXXXXXXXXXXXXXXXXXXXXXXXXXXXXXXXXXXXXXXX----XXXX----XXXXXXXXXXXXXXXXXXXXXXXXXXXX------------XXXXXXXXXX
