--------------------------------------------------------------------------------------------------------------------------------------------
--------------------------------------------------------------------------------------------------------------------------------------------
--------------------------------------------------------------------------------------------------------------------------------------------
--------------------------------------------------------------------------------------------------------------------------------------------
--------------------------------------o-----------o----------------------------------o---------------o-----o--------------------------------
------------------------------------------o------o-o-o----------------------------oo------------o--oo-o-----oooo-o--------------------------
------------o-------------o-------------o--------------o-o-----o-o----o---o-----oo--o------------oo----oo-------------------o---------------
---------oo--o---o-------o---o-o---o---------?-o--??S--------oo-o---o--o-----o-------X--o------?-------?--S?-X---------o--------------------
------------------oo--o----oo-o---o-oo---------X-?------?-ooo------o--XS?-----o-------o-----o-----------------?X----------?SS---------------
--------o-??X?------oo?--???S?-X?------------------------------------o-------------------ooo----------------------------SS------------------
------?-?---------------------------------------------------------?SS?----------------?X---X------------------------------------------------
--------------------------------------XXXXXXXX----XXXX----------------------------XXXX--------XXXXXXXXXXXXXXXX--------------------XXXXXXXXXX
--------------XXXX--------------------XXXXXXXXXXXXXXXXXXXX------------XXXX--------XXXX--------XXXXXXXXXXXXXXXXXXXX--------XXXX----XXXXXXXXXX
XXXXXX----XXXXXXXX----XXXXXXXXXXXXXXXXXXXXXXXXXXXXXXXXXXXXXXXXXXXX----XXXXXXXXXXXXXXXX--------XXXXXXXXXXXXXXXXXXXXXXXXXXXXXXXXXXXXXXXXXXXXXX
