--------------------------------------------------------------------------------------------------------------------------------------------
--------------------------------------------------------------------------------------------------------------------------------------------
--------------------------------------------------------------------------------------------------------------------------------------------
--------------------------------------------------------------------------------------------------------------------------------------------
---------------------------------------oo---o-o-oo-----------------o--o---o------------o----oo----------------------------------------------
---------o--o---o------o-----o--------o------o-o--------------------o-------o-o-o---o-o-ooo---------o--------------o------------------------
----------o-----------------o------------oo----------------oo-ooo----o-o-o---o-------------o------------------oo----o-----------------------
-------o-----o-----oo---oooo-------o----------?SX?oo---oo----o----???----X-?---o-o-o--?-?X-??S-----o-o----o-o---------o------o--------------
------XX--X?------o--o-???-?S-o-----------------------??--o--------------------------------------o---------o---X??-X---oo-------------------
-------------------------------oo-------------------------------XS----------------------------oo---------S---o-----------?ooo---------------
------------------------------SX?S--S-------------?S?-----------------------------------------------------SX??------------S?X?--------------
--------------XXXX--------------------XXXXXXXXXXXX----------------XXXXXXXXXXXX--------XXXXXXXX--------------------------------XXXXXXXXXXXXXX
XXXXXXXXXXXXXXXXXX----XXXXXXXX--------XXXXXXXXXXXX----XXXX--------XXXXXXXXXXXXXXXXXXXXXXXXXXXX----XXXX--------XXXXXXXX--------XXXXXXXXXXXXXX
XXXXXXXXXXXXXXXXXX----XXXXXXXX--------XXXXXXXXXXXX----XXXXXXXXXXXXXXXXXXXXXXXXXXXXXXXXXXXXXXXX----XXXXXXXX----XXXXXXXXXXXX----XXXXXXXXXXXXXX
