--------------------------------------------------------------------------------------------------------------------------------------------
--------------------------------------------------------------------------------------------------------------------------------------------
--------------------------------------------------------------------------------------------------------------------------------------------
--------------------------------------------------------------------------------------------------------------------------------------------
-------------------------------------o------------------------------------------------------------------------------------------------------
------o--o-------------------o---o-----o---o------o--o----oo---------------------------o------o--o------------------------------------------
-----------o--------------o--------oo---o----------------o--o---------------oo----------o-------o--o-o-------------------o------------------
-------oo-o-o--------o-o---oo-oo--?XS-o--o----ooo-XX?-o-o------------o--------------o----oo--o--------ooo--------o--o-o-o-o-o---------------
------?-S??S----o--oo-o-ooS?-X-???---------------------o----------S?--oo--o---oo-oo---?----o------o-o----Xoo--oo--------?----X--------------
-------------------------------------------------o----X-----------------oo?----------o----------------------o--XS---------------------------
-----------------------------------------------XXX------------?-X?-----XX----------?SX----X?-S------------??-?------------------------------
----------------------------------XXXX----XXXX----XXXX----XXXX------------------------------------------------------------------------------
XXXXXXXXXXXXXX------------XXXXXXXXXXXXXXXXXXXX----XXXX----XXXX----XXXX----------------XXXX----XXXX----XXXX--------XXXXXXXXXXXX--------------
XXXXXXXXXXXXXX--------XXXXXXXXXXXXXXXXXXXXXXXX----XXXXXXXXXXXX----XXXX----XXXX--------XXXX----XXXXXXXXXXXX----XXXXXXXXXXXXXXXXXXXX--XXXXXXXX
