--------------------------------------------------------------------------------------------------------------------------------------------
--------------------------------------------------------------------------------------------------------------------------------------------
--------------------------------------------------------------------------------------------------------------------------------------------
--------------------------------------------------------------------------------------------------------------------------------------------
------------------o-o-----------------------------oo------------------------o--o------------o-----------------------------------------------
-----------o---o---o---o---o-o-----------------ooo--o-----------------o-o-------oo-------o---------o-o------o-------------------------------
-----------------o-------o----------------------------------o--o-------o--o---o---o--oo---oo-oo---o--------o--oo---------o------------------
--------ooo-o-X-------------------o--o-o-oo--o--XXS--?--o-o---o---o---------X----------oo-?SS?--o---o----Xo-----o--o-oo-o---o---------------
-------o--??X-------------?-??o----o---------------------o-----------o-???---------o--?XX?-------o---------?SS---------o--------------------
-------------------------------o----o---o-X--?--------o--------------?-------------S----------?-----------------?S------??o--o--------------
---------?--------------------???-??--------------------------------------------------------------------------------------?-----------------
--------------XXXXXXXXXXXX--------------------XXXXXXXX--------------------XXXXXXXX--------XXXX--------XXXX----------------------------------
XXXXXX----XXXXXXXXXXXXXXXXXXXX----------------XXXXXXXX----XXXX--------XXXXXXXXXXXX----XXXXXXXX----XXXXXXXXXXXX----------------XXXX----------
XXXXXX----XXXXXXXXXXXXXXXXXXXX------------XXXXXXXXXXXX----XXXXXXXXXXXXXXXXXXXXXXXXXXXXXXXXXXXXXXXXXXXXXXXXXXXXXXXXXXXXXXXX----XXXXXXXXXXXXXX
