--------------------------------------------------------------------------------------------------------------------------------------------
--------------------------------------------------------------------------------------------------------------------------------------------
--------------------------------------------------------------------------------------------------------------------------------------------
--------------------------------------------------------------------------------------------------------------------------------------------
--------------------o-------------------o-------------------------------------------------------------o-o-----------------------------------
--------o-------------o-oo------------o-----o--------------o-o---o-o----------oo-o--------o--o-----oo------oo-o-----------o-o---------------
---------o----o-o--o-o----o-o-o------------o-o---oo------------------o--oo------o------o-o----o---o--o---oo--o--------ooo-------------------
------oo--oooo---o-----o--------oo--oo----------------------o-oo--o-o-o--------------o--o--o--------------------o--o-o---o------------------
------S??X------------------X----------------S--o--------------????S-X-o-----o----oo------S???-o----------XXS--??---------????--------------
----------?-SSX-----------------X--------------?SX-?SS?SX-------------?-----o------X?S?X-?----??------------------S-------------------------
--------------------------------------------------------------------------------------------------------------------------------------------
------------------XXXX----------------XXXX------------------------------------------------------------XXXX----------------------------------
XXXXXXXXXX--------XXXXXXXXXXXX----XXXXXXXXXXXX------------XXXXXXXXXXXX--------XXXX--------XXXX----XXXXXXXXXXXXXXXX--------XXXXXXXX--XXXXXXXX
XXXXXXXXXXXXXXXXXXXXXXXXXXXXXXXXXXXXXXXXXXXXXXXXXXXXXXXXXXXXXXXXXXXXXXXXXX----XXXXXXXXXXXXXXXXXXXXXXXXXXXXXXXXXXXXXXXXXXXXXXXXXXXX--XXXXXXXX
