--------------------------------------------------------------------------------------------------------------------------------------------
--------------------------------------------------------------------------------------------------------------------------------------------
--------------------------------------------------------------------------------------------------------------------------------------------
--------------------------------------------------------------------------------------------------------------------------------------------
------------o--oo---------o-------------------o------------o-----------------------------------------------------o--------------------------
--------oo-----------------o-ooo--------o-------oo--------------------------o-o----o----------o---------------oo--------o-o-o---------------
----------oo--------o-----------------oo-----------o----oo---o------------------oo--------o-oo---o--------------o---------------------------
-------o--???----------o-o---?-------o---o-----X-?o-ooX?-S----o--o---o---------o-----X--o--o----------o----o--SSXS-----o--------------------
-------S-----------o-o--------S??--o--------o-----?XXS------------o---oo-----------------o?-?---------???So----------o--?SS??---------------
----------------------o-o--------------------------------------o--------o-------------oo----------ooo--------o-----o------------------------
-------------------------?------------------?---------------------S?SS??X--------------?S?----------??----X-?X------------------------------
----------XXXXXXXX--------XXXX----------------XXXX----XXXXXXXX--------------------XXXX------------------------XXXX--------------------------
XXXXXXXXXXXXXXXXXX--------XXXXXXXX----XXXX----XXXXXXXXXXXXXXXX------------XXXXXXXXXXXX----XXXXXXXX----XXXX----XXXX----XXXXXXXX--------------
XXXXXXXXXXXXXXXXXXXXXX----XXXXXXXXXXXXXXXX----XXXXXXXXXXXXXXXX------------XXXXXXXXXXXX----XXXXXXXX----XXXX----XXXX----XXXXXXXXXXXXXXXXXXXXXX
