--------------------------------------------------------------------------------------------------------------------------------------------
--------------------------------------------------------------------------------------------------------------------------------------------
--------------------------------------------------------------------------------------------------------------------------------------------
--------------------------------------------------------------------------------------------------------------------------------------------
----------------------o-o-----------------------------------------------------ooo-------------------oo--------------------------------------
---------------------o-o-----o------------o-------oo-o-------o------------o-----------------------o-------------------ooo-------------------
--------oo----o-o--o--------o--o-------o------------------oo---o----o------------o---------o-o-----o----o------ooo--------------------------
-------o-----oS-?-o-o---?X-o--o---o-----o--S??-o-oS-?X-o------o----o-o---o--o----------oo-o-o--ooo------------------------o-----------------
----------o----------------?-?--------o--o------------o-----------?S?X-o--XX----------o--oX-??----------?-oo-oo---o-----X--oo---------------
------S?X?--o-----------------SS--------------X-?S------o-------------o------------o-oXX--------------------o-------oo-------o--------------
----------?--?----------------------------------------??--------------SS?X--------------------------------X??--------------S-X--------------
--------------XXXX----XXXX----------------XXXX----XXXX----XXXX----------------XXXX----------------XXXX----------------------------XXXXXXXXXX
--------------XXXXXXXXXXXXXXXX------------XXXX----XXXX----XXXXXXXXXXXX----XXXXXXXX--------XXXXXXXXXXXXXXXX------------XXXX--------XXXXXXXXXX
XXXXXXXXXX----XXXXXXXXXXXXXXXXXXXX----XXXXXXXXXXXXXXXX----XXXXXXXXXXXX----XXXXXXXX----XXXXXXXXXXXXXXXXXXXX----XXXX----XXXX----XXXXXXXXXXXXXX
