--------------------------------------------------------------------------------------------------------------------------------------------
--------------------------------------------------------------------------------------------------------------------------------------------
--------------------------------------------------------------------------------------------------------------------------------------------
--------------------------------------------------------------------------------------------------------------------------------------------
---------------------------------------------------------------------------o-------------------o----oo--------------------------------------
-----------o------o---------------------oo------------------------------------o-------------o---o-----o-------------------o-o---------------
------------oo--------o--o--------o-o--o------o------------o-o-----------------oooo-oo-----o-----ooo------oo-----------------o--------------
-------o-o-----oo--o-o--------------------o------o--o-----o---------o--o--???S-----o---oo-o--o--------------ooo-------o----?-S--------------
--------o-?XSXo--------------oo-o-----------o-----o------o------------o-------------------X--------------------o--------oo------------------
------o--------------------o---------?--------XS-X-o-oooo----------??S--o----------------o----------------?S?-S???-o---o--------------------
-------X??----------------?-SSS?SX----------X?----SS------------??----SXSX-------------XSX-------------------------??----?------------------
--------------------------------------------------------------------------XXXXXXXX------------XXXXXXXX--------------------XXXX--------------
XXXXXX----XXXX----XXXXXXXX------------XXXX----------------XXXX------------XXXXXXXXXXXX----XXXXXXXXXXXXXXXX----------------XXXXXXXXXXXXXXXXXX
XXXXXX----XXXX----XXXXXXXX--------XXXXXXXX----XXXX--------XXXX----XXXX----XXXXXXXXXXXX----XXXXXXXXXXXXXXXXXXXXXXXX--------XXXXXXXXXXXXXXXXXX
