--------------------------------------------------------------------------------------------------------------------------------------------
--------------------------------------------------------------------------------------------------------------------------------------------
--------------------------------------------------------------------------------------------------------------------------------------------
--------------------------------------------------------------------------------------------------------------------------------------------
------------------------------o-------o-o--------------------------o--------o-ooo-----------o------------------o-------oo----o--------------
---------------------------------oo------o--------------------o---o--------------o---------------------o---oooo--o----------o---------------
-------oo---------------o---oo-oo------o---------o--------o-o----------o-----------------ooo-------ooo--o-------------o----o----------------
---------o--o----o--------o---?X??--------------o-o--o-------------???---------------ooo--S?-Xo-o-----o--o----X?X?-------X-?S?--------------
----------o---------oo-o----------?----------o-----------o---o--------o-o----------oo------------o--------SSS------o-o----------------------
-------S??---------o--X--S?-?S------------o-----SS----o---------------XSX?--------o---?X?-------------------------X?------------------------
-----------X?S-------?----------------------??-----?--------------------------------?S------------------------------------------------------
------------------------------XXXX----XXXX--------------------XXXXXXXX----XXXXXXXX--------XXXX----XXXX--------XXXX----XXXXXXXX--------------
--------------XXXX------------XXXXXXXXXXXX--------------------XXXXXXXX----XXXXXXXX--------XXXX----XXXXXXXXXXXXXXXX----XXXXXXXX--------------
XXXXXXXXXX----XXXX----XXXXXXXXXXXXXXXXXXXX----XXXX--------XXXXXXXXXXXXXXXXXXXXXXXX----XXXXXXXXXXXXXXXXXXXXXXXXXXXXXXXXXXXXXXXX----XXXXXXXXXX
