--------------------------------------------------------------------------------------------------------------------------------------------
--------------------------------------------------------------------------------------------------------------------------------------------
--------------------------------------------------------------------------------------------------------------------------------------------
--------------------------------------------------------------------------------------------------------------------------------------------
----------o---------------------------------------o--------------------o--------o-o-----------------o---o-----------------------------------
-----------o---o--------o-o--oo-o---------o----------o-------------------------o-o------------oo-o-o-o-o------------------------------------
------------o----o--o-o-----o---------o-----oo---o-o-------oo---------o-------------o--oooo-----o-o------------o----------------------------
--------o-X?-------o---o---------------oo-------o-X--?---o----o----------X-oo---------------o------------S------o-----o-oo--oo--------------
---------o-----?--o---S-S???-X?-------------------------------------o-----o--o-------------o----------------ooo------o----o-----------------
----------------------------------oo-o--------S-?X----?-----------oo-o----S-----------SXXSS?-S--------------???S-?------???X----------------
-------?-S----------------------------------------------------????X??----------------------------------------------?------------------------
XXXXXX----XXXX----------------------------XXXX----XXXX----XXXX--------XXXX----XXXXXXXX------------XXXXXXXX----------------------------------
XXXXXX----XXXXXXXX----XXXXXXXXXXXX--------XXXX----XXXX----XXXX--------XXXX----XXXXXXXX--------XXXXXXXXXXXX----------------------------------
XXXXXX----XXXXXXXXXXXXXXXXXXXXXXXX----XXXXXXXXXXXXXXXXXXXXXXXX--------XXXXXXXXXXXXXXXXXXXXXXXXXXXXXXXXXXXXXXXXXXXX----XXXXXXXX----XXXXXXXXXX
