--------------------------------------------------------------------------------------------------------------------------------------------
--------------------------------------------------------------------------------------------------------------------------------------------
--------------------------------------------------------------------------------------------------------------------------------------------
--------------------------------------------------------------------------------------------------------------------------------------------
-------------------------------------oo-----------------------------o-----------------------------------------------------------------------
----------------------------------o-----oo--------o--------ooo----o-----------oo----------------------------------oo------------------------
-----------------------------------o---o-------oo--------o-----------oo-----------o-ooo---o--------------o-----------o----------------------
----------o-----o---------o--o-------?--------o----o-o------------????---o-o----oo---------oooo------------o-o--oo--------ooo---------------
---------o-oo-----o-o-o----oo-------------o------o-S??--------o--o------o-----X--------ooo--------oo-o----X?X?o-------oo-----o--------------
-------o--X--------o--?S?-----o--------------o?------------------------S?So-----------SS-?X?-X---o--o----------o---------o------------------
--------XX----------------?--X??X?----------------------------------------?X----------------------------------?---------SX?-----------------
----------------------------------XXXXXXXX------------XXXX--------XXXX------------XXXX----------------------------------------XXXX--XXXXXXXX
----------------------------------XXXXXXXX--------XXXXXXXXXXXX----XXXX--------XXXXXXXX----------------XXXXXXXX----XXXX--------XXXX--XXXXXXXX
XXXXXX----XXXXXXXX----XXXX--------XXXXXXXX----XXXXXXXXXXXXXXXXXXXXXXXXXXXX----XXXXXXXXXXXXXXXX--------XXXXXXXX----XXXX--------XXXX--XXXXXXXX
