--------------------------------------------------------------------------------------------------------------------------------------------
--------------------------------------------------------------------------------------------------------------------------------------------
--------------------------------------------------------------------------------------------------------------------------------------------
--------------------------------------------------------------------------------------------------------------------------------------------
--------------------------------o--------------oo-----------------------------------------------------------o----------o--------------------
--------o-oo------oo----o------------------o------o---------------------------oo---ooo--------------o-o---------------o-o-------------------
---------o-------o--oo-o------o--oo-o--o-o----o--o--oo--------------o-----------ooo--------o-------o-o-----o-oo-----------------------------
----------------------o---o----?XS-o--o-----?X??-X-o----ooo-------o--oo-----oo-------?o-----o----o---?-???-SS--o---o-----X--oo--------------
--------XSX-S?-o-------------o----------o---------S???o-----o----o------ooo--------------oo-----o---------------?----------o----------------
---------------XSX---------oo-------------------------S-------oo--?S-X-o---------------X-X--S-o---------------------------------------------
---------------------------XX?---------------------------------??S-----?--------------------------------------------------S--?--------------
------------------------------XXXX--------XXXXXXXX--------------------------------XXXX------------XXXXXXXXXXXX--------XXXX----XXXX----------
XXXXXXXXXXXXXX----XXXXXXXX----XXXX--------XXXXXXXXXXXX------------------------XXXXXXXX------------XXXXXXXXXXXXXXXX----XXXX----XXXX----------
XXXXXXXXXXXXXXXXXXXXXXXXXX----XXXXXXXXXXXXXXXXXXXXXXXXXXXX--------XXXX----XXXXXXXXXXXXXXXXXXXX----XXXXXXXXXXXXXXXXXXXXXXXX----XXXXXXXXXXXXXX
