--------------------------------------------------------------------------------------------------------------------------------------------
--------------------------------------------------------------------------------------------------------------------------------------------
--------------------------------------------------------------------------------------------------------------------------------------------
--------------------------------------------------------------------------------------------------------------------------------------------
-------------------------------------------------o--------o---------------------------------------------------o------------o----------------
---------o-------o-ooo------------o--o----o-----o------o-o--o-----------------oo---------o----o--o-o-------o----o------o----o---------------
------ooo---------o----------------------o--------o---o----o-oo-o---------------o---o---o-ooo--o----o----------o---------oo-----------------
--------------------------o---ooo------oo----oS------o---------o-o----o---o-o--------o----?X??----o--o-o-----o??--o--oo-o--X-S--------------
--------SXo---X-------o------o---o------?----?-----o-----------S-----o-o---o-o--------????----------------???------------S------------------
-----------o--------------------------------------?S?------------------------------??X-----------------?-X----------------------------------
----------S-X------------?XX?SSS-----------------------------------?-SX--?------------------------------------------------------------------
----------------------------------XXXX--------XXXX--------XXXX----------------------------XXXX----------------XXXX--------XXXX--------------
XXXXXXXXXX----XXXXXXXX------------XXXXXXXXXXXXXXXX----XXXXXXXXXXXX------------XXXX----XXXXXXXXXXXXXXXX----XXXXXXXX----XXXXXXXX----XXXXXXXXXX
XXXXXXXXXX----XXXXXXXX------------XXXXXXXXXXXXXXXXXXXXXXXXXXXXXXXX--------XXXXXXXXXXXXXXXXXXXXXXXXXXXXXXXXXXXXXXXX----XXXXXXXX----XXXXXXXXXX
