--------------------------------------------------------------------------------------------------------------------------------------------
--------------------------------------------------------------------------------------------------------------------------------------------
--------------------------------------------------------------------------------------------------------------------------------------------
--------------------------------------------------------------------------------------------------------------------------------------------
--------------o-oo------------oo---------------------------------o--------------o-----------------------------------------------------------
--------oo------------o---o--o----------------------------------------oo------o-----------o----o------o-----------o---o--o-o----------------
------o-------------------------o-o-o------o------------o-----o------o--o----o-o---o-o-------o-----o----------o--o------o---oo--------------
-----------o--S---o-----o-??SX?SS?---o--------------o--o--o-o------------o--------------------?XS?--o--o----o--o----oo-o--------------------
----------o-----------S-?S--------X-?-o-o------o-----oS-----------o-o-S?-?-------------oo-?SS--------------o-oS----S----?--???--------------
-------------o-----oo------------------o-o------o-o--------o---------S----S-----------S--X----------------S??S------------------------------
----------SS?S---------------------------------X-XSXS---------------------------------------------------------------------------------------
--------------XXXX--------XXXXXXXX----------------------------XXXX------------XXXX------------XXXX------------------------------------------
XXXXXXXXXX----XXXX----XXXXXXXXXXXXXXXX----------------XXXX----XXXX----XXXX----XXXXXXXX----XXXXXXXX----XXXX----XXXXXXXXXXXXXXXX--------------
XXXXXXXXXX----XXXX----XXXXXXXXXXXXXXXX----XXXX--------XXXX----XXXXXXXXXXXXXXXXXXXXXXXXXXXXXXXXXXXXXXXXXXXXXXXXXXXXXXXXXXXXXXXXXXXXXXXXXXXXXX
