--------------------------------------------------------------------------------------------------------------------------------------------
--------------------------------------------------------------------------------------------------------------------------------------------
--------------------------------------------------------------------------------------------------------------------------------------------
--------------------------------------------------------------------------------------------------------------------------------------------
------------------o-o------o--------------------------------------------------o------o-------------o-o--------------------------------------
-------------o-----o------o----------o--------o--o-------o--------------o-------o-----------------o------o-oo-------------------------------
-------ooo--o--o-o----o-----oo-----------------oo-oo----o---------oo--o------o-o-oo-o---------------o-o---o--o-o--o-------------------------
----------oo-----------o--X-??------o-o-o--oo---------XS--------o---o-XX?X---------S--oo----o----------??-?-S-------o-ooo-------------------
----------SXX?----------o--------o------------??X??X-?----o----------------???----------oo--------------------o----------oooo---------------
-------S----------------?-----ooo--------o---o-------------ooo----??S---------------------o--o-------------------------------o--------------
------------------------------S-X?---------S-?------------X---------------------------??-X?---------------------------------X---------------
------------------XXXX----XXXX------------------------XXXX------------XXXX----XXXXXXXX------------XXXXXXXXXXXX------------------------------
----------XXXX----XXXX----XXXX----XXXX--------XXXXXXXXXXXX----XXXX----XXXXXXXXXXXXXXXX------------XXXXXXXXXXXX----XXXX----------------------
XXXXXXXXXXXXXXXXXXXXXXXXXXXXXX----XXXX--------XXXXXXXXXXXX----XXXXXXXXXXXXXXXXXXXXXXXX------------XXXXXXXXXXXXXXXXXXXX--------XXXX--XXXXXXXX
