--------------------------------------------------------------------------------------------------------------------------------------------
--------------------------------------------------------------------------------------------------------------------------------------------
--------------------------------------------------------------------------------------------------------------------------------------------
--------------------------------------------------------------------------------------------------------------------------------------------
-------------------------------o------o-------------------------------------------o-----oo------------o-------------------------------------
-------o--------oo------------o----o---o----------------oo------------------------------------------------------------o-oo------------------
--------------o-------o-----------------oo--------o--o------oo----o------------o-o-----o---------o-----o------oo------------o---------------
------o-ooo-ooS-----o--o---o--??-Xo--------------o--------oo--------o---o----o--o-----S???----oo--o----------o???S-----o--------------------
------??XX-o------o--o--oo--oo----S--?----o-ooo----o---?-------o---o--oo--o---o-------------o-------o------oo-----------?Xo--o--------------
-------------------o--------?S-------------o----o--?--------------X?X?-----X--------------oo---------o----?S--------oo------??--------------
----------S?SX---------------------------------X?--------------???----X?X?----------------??X---------------------S-------------------------
--------------XXXX------------XXXX----XXXX----------------------------------------XXXXXXXX------------XXXX----XXXX--------------------------
XXXXXXXXXX----XXXX------------XXXXXXXXXXXX------------XXXXXXXX--------------------XXXXXXXX------------XXXX----XXXX----XXXX------------------
XXXXXXXXXX----XXXX----XXXXXXXXXXXXXXXXXXXX--------XXXXXXXXXXXX----XXXX----XXXXXXXXXXXXXXXX----XXXX----XXXXXXXXXXXX----XXXXXXXX------XXXXXXXX
