--------------------------------------------------------------------------------------------------------------------------------------------
--------------------------------------------------------------------------------------------------------------------------------------------
--------------------------------------------------------------------------------------------------------------------------------------------
--------------------------------------------------------------------------------------------------------------------------------------------
------o-o-------------------------------------o-o--------------------------------------------------o-o--------------------------------------
---------o---------oo--------------------------o--o----------------------o-----------------oo-----o----------o------------------------------
-----------o------o----------o--------o--o-------o------o------------o-o-----------------------o----o----oo-o-------------------------------
-------X?X--o----------o------------------o-o-X??S--oo-o----oo-----o--o------o--o-oo-o--o--X-----------o------ooo---o--o--o--o--------------
----------o-----oo--------o-o-o---------o---------?X?So---oo----o---o-?-?-----oo-------o-o------oo--------?S?X---oo--------??---------------
----------XX-X??S------------S----S--------o-o--------?--?X-----XX?SS?----ooo-------o---------S--------------------o--o---------------------
------------------------------?X-X-----------------------------------------------------?S?----------------------???SX----?------------------
XXXXXXXXXX------------------------------------XXXX----------------------------------------XXXX----XXXX------------------------XXXXXXXXXXXXXX
XXXXXXXXXX--------XXXX------------------------XXXXXXXX----------------XXXX----------------XXXX----XXXXXXXXXXXX------------XXXXXXXXXXXXXXXXXX
XXXXXXXXXXXXXXXXXXXXXXXXXXXXXX----XXXXXXXX----XXXXXXXXXXXXXXXXXXXXXXXXXXXX----XXXX--------XXXXXXXXXXXXXXXXXXXX------------XXXXXXXXXXXXXXXXXX
