--------------------------------------------------------------------------------------------------------------------------------------------
--------------------------------------------------------------------------------------------------------------------------------------------
--------------------------------------------------------------------------------------------------------------------------------------------
--------------------------------------------------------------------------------------------------------------------------------------------
-----------------o-----------------------------------------------------------------------o------------o--o---------------o------------------
--------oo--------------------o-o-----o-oo-------------------------------------------o----oo-o-----oo------------------o--------------------
------o-------------oo------o----------o-----------oo------o-o------o-o------------o-----------------o----------------o---------------------
-------??-----?--------oo-oo---------o----------o-o----o----o--o-o-o-o-ooo-o---oo-------S?--??----------X------o--------?Xooo---------------
-------------------------o-?-S?-X?----------o-o---??-?---o-------------------o---o--------------o-----------o-o----o---------o--------------
----------o-----------o------------oo------------o----o---?X--o-o----X??-X--------------------o------------o-o-------------?X?--------------
----------X-S---------?-------------------------S?-----?-?------------------------------------?-------------?XX?----------------------------
XXXXXXXXXX----XXXXXXXX----------------XXXX----------------------------------------XXXXXXXXXXXX--------XXXX------------XXXX----XXXXXXXXXXXXXX
XXXXXXXXXX----XXXXXXXX----XXXXXXXX----XXXX--------XXXX----------------------------XXXXXXXXXXXX----XXXXXXXX------------XXXX----XXXXXXXXXXXXXX
XXXXXXXXXX----XXXXXXXX----XXXXXXXX----XXXXXXXX----XXXX----XXXX----XXXXXXXXXXXX----XXXXXXXXXXXX----XXXXXXXX--------XXXXXXXXXXXXXXXXXXXXXXXXXX
