--------------------------------------------------------------------------------------------------------------------------------------------
--------------------------------------------------------------------------------------------------------------------------------------------
--------------------------------------------------------------------------------------------------------------------------------------------
--------------------------------------------------------------------------------------------------------------------------------------------
----------o-------------oo--------------------------o-----oo-o-----------------------------------------------------------o------------------
---------o-----o-o----o------------o-o------------o---o--o--o-------------o-------o---------------o-----------o-----------------------------
-----------o--o-o-----------o----------------------o-o-o------oo--o-o--o------o--o------o-o--------o------o-oo-o------ooo---o---------------
------?S?-XS-S----ooo-S---o--oo--------o--oo----o-X-X----------?-X---o-----o---oo----------o-o------oo--oo----XX--------XXo-----------------
----------------------------------X?-?--o--------o--------------------o-oo--X-------XSoo-o????--o----------o---------o-----o----------------
--------------------------??----o-------------oo------------------XXS????-------------S??S-------o----o----?XX----o--------??---------------
------------------------------???--------------S?S--------------------------------------------?---------S-----------------------------------
XXXXXXXXXXXXXX--------XXXX------------------------XXXX----XXXXXXXX--------------------------------------------XXXX----XXXX--------XXXXXXXXXX
XXXXXXXXXXXXXXXXXXXXXXXXXX--------XXXX------------XXXXXXXXXXXXXXXX--------XXXX----XXXX----XXXX----XXXX--------XXXX----XXXX--------XXXXXXXXXX
XXXXXXXXXXXXXXXXXXXXXXXXXXXXXX----XXXX----XXXX----XXXXXXXXXXXXXXXXXXXXXXXXXXXXXXXXXXXXXXXXXXXX----XXXX----XXXXXXXX----XXXXXXXX----XXXXXXXXXX
