--------------------------------------------------------------------------------------------------------------------------------------------
--------------------------------------------------------------------------------------------------------------------------------------------
--------------------------------------------------------------------------------------------------------------------------------------------
--------------------------------------------------------------------------------------------------------------------------------------------
-----------------------------------o-o------------------o--------------------------o---o------------o---------------------------------------
------------------------------------o--------------------------oooo-o-o-o----o------o-------o-----o--o--------------oo-----o----------------
----------o--o--o--o--o-----------o----------------o-o-------------------ooo--ooo--------oo--o--o--o--o-o-----oo-o----------oo--------------
--------oo-o------o-o-------------?----o----X-------o--X?-o-o-o----o-o-o--X-?----o---X?S??-------o-------o------------oo--o-----------------
------o------------------o--oooo--------------o--oo--------o-------?S-?-??----------------?X?----------o---ooo-----------o??----------------
------??S-???------------?------o-----o-oo--------S?-X------------------------------------------------XXSS?-?XX---------?X------------------
---------------------------S?XX-SS------------SX-X------------------------------------------------------------------------------------------
----------------------------------XXXX----XXXX--------XXXX----------------XXXX----XXXXXXXX--------XXXX------------------------XXXX--XXXXXXXX
--------------XXXXXXXX------------XXXX----XXXX--------XXXX----XXXXXXXXXXXXXXXX----XXXXXXXXXXXX----XXXX------------XXXX----XXXXXXXX--XXXXXXXX
XXXXXXXXXXXXXXXXXXXXXXXXXX--------XXXX----XXXX----XXXXXXXX----XXXXXXXXXXXXXXXXXXXXXXXXXXXXXXXXXXXXXXXXXXXXXXXXXXXXXXXXXXXXXXXXXXXX--XXXXXXXX
