--------------------------------------------------------------------------------------------------------------------------------------------
--------------------------------------------------------------------------------------------------------------------------------------------
--------------------------------------------------------------------------------------------------------------------------------------------
--------------------------------------------------------------------------------------------------------------------------------------------
---------------o----------------o---o--------------o--------------------------------------o---------------oo-o------------------------------
------------------ooo--------------------------o----o-----oo-ooo---o--oo-----------------o-o---o------o-----o-------------------------------
------o--o------o-----------o-oo-o--------------o-o--oo-oo--o------------o-----oo---ooooo-----o----------------o----------------------------
----------oo---?---------o---oSXX?-----o-oo-----S??SS---------------oo?--?---o---o-o------???X-------o--S-??SSo------------o----------------
----------------------o----o----------o----------------o----------SXS-----oo--o------S-?SS----?---oo----------?S------o-ooo-----------------
-------?S?---o------------SS??----------o-------------?XX-------------------------------------------o--------------o-o----------------------
-----------S?S----------??------------------------------------------------S--?------------------------------------------S-?X-S--------------
--------------XXXX------------XXXXXXXX--------XXXXXXXX----XXXXXXXX----XXXX----------------XXXX--------XXXXXXXX--------------------XXXXXXXXXX
--------------XXXXXXXX--------XXXXXXXX--------XXXXXXXX----XXXXXXXXXXXXXXXX--------XXXXXXXXXXXXXXXX----XXXXXXXXXXXX----------------XXXXXXXXXX
XXXXXXXXXX----XXXXXXXX----XXXXXXXXXXXX--------XXXXXXXXXXXXXXXXXXXXXXXXXXXX----XXXXXXXXXXXXXXXXXXXX----XXXXXXXXXXXX----------------XXXXXXXXXX
