--------------------------------------------------------------------------------------------------------------------------------------------
--------------------------------------------------------------------------------------------------------------------------------------------
--------------------------------------------------------------------------------------------------------------------------------------------
--------------------------------------------------------------------------------------------------------------------------------------------
-------o----------o-oo------------o--o------------------------------------------------------------------------------------------------------
------o---o----o------o-----------------------------------------------------oo--o-----------------o-o-------------------oo------------------
--------oo-oo----o-o---------------oo-oo----------o--o----o----------oo--o----o---------oo-o---------o-----------------o---o----------------
------?X-S----o--------oo-oo-oo---X-X---o--------o?S-?o----o-o------o---o------o----------o--------o-------ooo-o---o-o--X?---o--------------
------------S?S--?--------------o---------------o--------o--o--o---o---------------o-oo---S?----o----So----??So--o--o------SSS--------------
----------------------------?--o-o---------o--------------------------SX----------S---??SX--------------o-------o---------------------------
------------------------------SX?X---------?-XSS------------------------------------------------?-----?S-?----X-X---------------------------
XXXXXXXXXX--------XXXX------------XXXX------------XXXX--------------------XXXX----------------------------------------XXXX--------XXXXXXXXXX
XXXXXXXXXXXXXXXXXXXXXXXXXX--------XXXXXXXX--------XXXX--------------------XXXXXXXX--------XXXX----XXXX----XXXX--------XXXXXXXX----XXXXXXXXXX
XXXXXXXXXXXXXXXXXXXXXXXXXXXXXX----XXXXXXXX--------XXXX----XXXX----XXXXXXXXXXXXXXXXXXXXXXXXXXXX----XXXX----XXXX--------XXXXXXXX----XXXXXXXXXX
