--------------------------------------------------------------------------------------------------------------------------------------------
--------------------------------------------------------------------------------------------------------------------------------------------
--------------------------------------------------------------------------------------------------------------------------------------------
--------------------------------------------------------------------------------------------------------------------------------------------
--------------------------o-oo---------------------------oo-o----------o---------o--o-------------------------------------------------------
-----------o--o--------------------------o--------------o--o-------------------o--o-------o-------oo-----------o----------o--o--------------
--------------------------------oo-----o-----o-----oo--o------------o-o-o-----o-o----o---------------------o-oo-----o---o-------------------
---------------?--o-oo-oo--XX?-o------o-o-------------?XS??----oo----oX-?S---o?--------ooo???--o----o--o----------o----o-o--X?--------------
------o-o-XS??----------------o---o--o----o------oo--o---------X-X-?-?----------------------------------ooo-----??--------------------------
---------o---------------o----??X--X---------?o-o--S??----------------------o-----------------------------S-X-----X-----??------------------
------??X--------------------------------------S-?------------------------S??---------------------------------------------------------------
--------------XXXX--------XXXX------------------------XXXXXXXX--------XXXX----XXXXXXXX----XXXX----------------------------XXXX--------------
XXXXXX----XXXXXXXX--------XXXX--------XXXX------------XXXXXXXXXXXXXXXXXXXX----XXXXXXXX----XXXX----XXXX--------XXXX--------XXXXXXXX----------
XXXXXX----XXXXXXXX--------XXXXXXXXXXXXXXXXXXXX----XXXXXXXXXXXXXXXXXXXXXXXX----XXXXXXXX----XXXX----XXXX----XXXXXXXXXXXXXXXXXXXXXXXXXXXXXXXXXX
