--------------------------------------------------------------------------------------------------------------------------------------------
--------------------------------------------------------------------------------------------------------------------------------------------
--------------------------------------------------------------------------------------------------------------------------------------------
--------------------------------------------------------------------------------------------------------------------------------------------
---------o------o---------o-o-------------------------------------o-o-------o--------------------------------o------------------------------
------o-o----------------------o------------------o-oo---------------o-------o-------------------------o-o----o--o--------------------------
-------o-------o-o--ooo----o-oo-o------------------o-------------------o---o--oo-o--------------o-----------o---------------o---------------
---------?---o?S?-oo-----oX-XX-----------o-------o-------o---o----?X-?----S-----o-ooo-o----------oooo---?S-??X----------oo-o-o--------------
----------oo------------------???----o-----o----o--X-X--o--o---o-o----o-o------------o-o-oooo-o------o--------S-?----------S----------------
-----------------------------------o---oo-----?X?S-----o----o----?----???-----------------S?--X?----------------------o---------------------
-----------?XX------------------------------??--------?-------------------------------X???------------------------------?-------------------
XXXXXXXXXX----XXXX--------XXXX------------------------------------XXXX----XXXX------------------------XXXXXXXX------------------------------
XXXXXXXXXX----XXXXXXXX----XXXXXXXX----------------XXXX------------XXXX----XXXX------------------------XXXXXXXXXXXX--------XXXX--------------
XXXXXXXXXX----XXXXXXXXXXXXXXXXXXXX------------XXXXXXXX--------XXXXXXXXXXXXXXXXXXXX--------XXXXXXXX----XXXXXXXXXXXX--------XXXXXXXXXXXXXXXXXX
