--------------------------------------------------------------------------------------------------------------------------------------------
--------------------------------------------------------------------------------------------------------------------------------------------
--------------------------------------------------------------------------------------------------------------------------------------------
--------------------------------------------------------------------------------------------------------------------------------------------
---------------------------------o-------------------------------------o------------------o-o------------------------------o----------------
----------------------oo----------o-oo------------------o-o----------------------o-----------o-o-o---------o-----o----o-oo---o--------------
---------o--------------------ooo-----------------ooo----o----------o-o-o---------o-o------o--o---------------o-o------o--------------------
--------o--o-------o--------o--??X---------o------?SXX-----o----o------?XX---oooo--o-o----?X?--------o------o--o--------X-X???--------------
------------------o-------o--------S??oo----o----o-------------------o----oo------------o---------ooo-----?SS-----oo------------------------
------SXX?o------o--o--------o----------oo---o--o-------------o---?-S?------o------S-----o--------------------------o-----------------------
-----------X???X?---------S??-------------------??------------??S----------S----------???S--------------------------------------------------
----------------------XXXX----XXXX----------------XXXXXXXX------------XXXX----------------XXXX--------XXXX------------XXXXXXXXXXXXXXXXXXXXXX
----------------------XXXX----XXXXXXXX------------XXXXXXXXXXXX--------XXXX----XXXX--------XXXXXXXX----XXXXXXXXXXXX----XXXXXXXXXXXXXXXXXXXXXX
XXXXXXXXXX------------XXXX----XXXXXXXX------------XXXXXXXXXXXX----XXXXXXXX----XXXXXXXX----XXXXXXXX----XXXXXXXXXXXX----XXXXXXXXXXXXXXXXXXXXXX
