--------------------------------------------------------------------------------------------------------------------------------------------
--------------------------------------------------------------------------------------------------------------------------------------------
--------------------------------------------------------------------------------------------------------------------------------------------
--------------------------------------------------------------------------------------------------------------------------------------------
-----------------------------o-----o-------------------o-o------------oo-o-----------o-------------------------------o----------------------
--------o-------------------o--------o----------------------------------o----o---------------------o--------------o-------o--o--------------
----------o-----------o---o----o------------------------o-----------------o-o-o---o-----------------o---------o-----o--ooo------------------
-------o-o-o-------oo-----XS-?o---?S--o--o------o-o--oSX---o-oo-------SS?S?X?---oo--X?-----oo--------------ooo-o------o----oo---------------
-------?XS--o-o----------o------o------o--o----o-o-------------------o-----------------o--o--o--oo-----------?-?XX--------X?SX--------------
----------?------oo----S?-----????------o--ooo??-S--------o-----------------------------ooXS----------o-----------------XS------------------
--------------------------------------------?X-----S---------------??S----------------SSXS-------------XXX----------------------------------
--------------------------XXXX----XXXX----------------XXXX------------XXXXXXXX----XXXX----------------------------XXXX----------------------
XXXXXXXXXX----------------XXXX----XXXX----------------XXXX----XXXX----XXXXXXXX----XXXX------------XXXX----XXXXXXXXXXXX----XXXXXXXXXXXXXXXXXX
XXXXXXXXXXXXXX--------XXXXXXXXXXXXXXXX--------XXXX----XXXX----XXXX----XXXXXXXXXXXXXXXX----XXXX----XXXX----XXXXXXXXXXXXXXXXXXXXXXXXXXXXXXXXXX
