--------------------------------------------------------------------------------------------------------------------------------------------
--------------------------------------------------------------------------------------------------------------------------------------------
--------------------------------------------------------------------------------------------------------------------------------------------
--------------------------------------------------------------------------------------------------------------------------------------------
------------------------------------------o---------------------------------o--------------------oo----------------------o------------------
-------------------------------oo------------o--------o---oooo---o------------------------------o--o-------------o--------------------------
-----------------------oo--o--o-----------------o-o------------oo----o-----o----------------o-------o--o-o-----------o-oo--ooo--------------
---------o------o--o-----------------o-o------SXSS--o---o-----------o----------o----------------------o-------oo--------S?-S??--------------
------?S?S-oo-----o-ooo-----ooX?SX----o-----------S?---X-------??Soo--o--o---------o-----o-o----------------oo??XXo-------------------------
----------o--o---o-------S-S-?----------o-------------------------?X-?-oo-----o-oo----o-o-?--?-------------o------SS------------------------
----------X?X???------------------------------------------------------X???------------??SX----------------X?-X------------------------------
------------------------------------------XXXXXXXX------------------------XXXX----------------XXXXXXXX----------------XXXXXXXX--------------
XXXXXXXXXX--------------------XXXX--------XXXXXXXXXXXXXXXXXXXXXXXX--------XXXX----------------XXXXXXXXXXXX----XXXX----XXXXXXXX--------------
XXXXXXXXXX--------XXXXXXXXXXXXXXXXXXXX----XXXXXXXXXXXXXXXXXXXXXXXXXXXX----XXXX------------XXXXXXXXXXXXXXXX----XXXXXXXXXXXXXXXXXXXXXXXXXXXXXX
