--------------------------------------------------------------------------------------------------------------------------------------------
--------------------------------------------------------------------------------------------------------------------------------------------
--------------------------------------------------------------------------------------------------------------------------------------------
--------------------------------------------------------------------------------------------------------------------------------------------
-----------------------ooo-----ooo---------o--------------o----oo-----------------o---------------------------------------------------------
------------------------------------o----------------------oo------------------------o-----------o---o-----------o--------------------------
-------------o------o---------o----o-o----o--o-----------o----o------oo---o---------o----o-----o----o---------o--------------o--------------
------o-o-oo------oo-----?----X?X?X----o------o---ooo---o--------X--o---------ooo-???S-o--o-------oo-----o-------------o---o----------------
-------o--XX?-------------------------o-oo-------o-??-S------------o----o--------o------o--oo--------?-------o?X?S---o--o-o-o---------------
------?X?S----------------oo-o-------------------------------------XXXS--S?-----------??S-------------o----o------------X-XS-?--------------
----------------------------X------------------X-?-----------------------------------------------------S-???--------------------------------
----------------------XXXX----XXXXXXXX----XXXX------------XXXXXXXX----------------XXXX--------XXXX----------------------------XXXX----------
----------XXXXXXXX----XXXX----XXXXXXXX----XXXX----XXXXXXXXXXXXXXXX----------------XXXX--------XXXXXXXX--------XXXX------------XXXX----------
XXXXXXXXXXXXXXXXXXXXXXXXXX----XXXXXXXX----XXXX----XXXXXXXXXXXXXXXXXXXXXXXXXXXXXXXXXXXXXXXX----XXXXXXXX--------XXXX----XXXXXXXXXXXXXXXXXXXXXX
