--------------------------------------------------------------------------------------------------------------------------------------------
--------------------------------------------------------------------------------------------------------------------------------------------
--------------------------------------------------------------------------------------------------------------------------------------------
--------------------------------------------------------------------------------------------------------------------------------------------
----------------o-------------------o-------------------------------------o----------------------o----------------------oo------------------
-----------o-o----oo--------------o-----o--------------------------------------oo-------o----------------------------o-o--------------------
---------o-------o--o---o---------------------oo-o--------o-------o--------o-oo-----------o-----o-o--------o-oo-------o---------------------
-------X-S----S------ooo-o-o--oo--??--oo-o--oo--o-o-o--o-o-oooo-------o----XX----oo-o-o--o--o------ooo-S----------oo----?-o-o---------------
----------SS?X-----------?--oo-------------o--X?-?-o-----------o-o---o--o-----------?--??--o--------X-------o--oo----------o----------------
--------------------------S??X???X--------o----------o----------o-SX-???S---------------------------------X??S?-?----------S-S--------------
--------------------------------------------------S-SX--------------------------------------------------------------------------------------
XXXXXXXXXX----XXXX----------------XXXX------------------------------------XXXX----------------XXXX----XXXX------------XXXX------------------
XXXXXXXXXXXXXXXXXXXXXXXXXX--------XXXXXXXX----XXXX----XXXXXXXX------------XXXXXXXXXXXXXXXX----XXXXXXXXXXXX--------XXXXXXXX--------XXXXXXXXXX
XXXXXXXXXXXXXXXXXXXXXXXXXXXXXXXXXXXXXXXXXX----XXXX----XXXXXXXX----XXXXXXXXXXXXXXXXXXXXXXXXXXXXXXXXXXXXXXXXXXXXXXXXXXXXXXXXXXXXXXXXXXXXXXXXXX
