--------------------------------------------------------------------------------------------------------------------------------------------
--------------------------------------------------------------------------------------------------------------------------------------------
--------------------------------------------------------------------------------------------------------------------------------------------
--------------------------------------------------------------------------------------------------------------------------------------------
-----------------------------------o----------------------------------------------o-------o-----------------o-------------------------------
----------o-------------------------o---oo---o----------o-------------------------------o-----------------o--o-o----------------------------
--------oo--------------------ooo----oo----------oo--------oo-o-o-o--o--oo---ooo---oo--o-o-o-------oo-oo---o------------o-o-oo--------------
------o----o----oo----oo-------------------X--------o----oo--o------o--o--o-----------o----?X?oo-----o-----?SX-----------o------------------
----------XS------ooo---?-oo-o-----------X----oo-----oSXX-------------o---?X----oo-----X-S------o-------------????----o---------------------
------?X-?-----o-----o----S?XS-X--------------X-S??S?S----------???-X?XS?X--------------------XS------------------------?S?S----------------
--------------------------------------------------------------------------------------------------------------------------------------------
----------------------------------XXXX----XXXX------------------------------------XXXX----XXXX--------XXXXXXXX----XXXX----------------------
----------XXXX--------XXXX--------XXXXXXXXXXXX--------XXXXXXXX------------XXXX----XXXXXXXXXXXX--------XXXXXXXXXXXXXXXX------------XXXXXXXXXX
XXXXXXXXXXXXXX--------XXXXXXXXXXXXXXXXXXXXXXXXXXXXXXXXXXXXXXXXXXXXXXXXXXXXXXXXXXXXXXXXXXXXXXXXXXXXXXXXXXXXXXXXXXXXXXXXXXXXXXXX----XXXXXXXXXX
