--------------------------------------------------------------------------------------------------------------------------------------------
--------------------------------------------------------------------------------------------------------------------------------------------
--------------------------------------------------------------------------------------------------------------------------------------------
--------------------------------------------------------------------------------------------------------------------------------------------
------------------o---------o-----------o------------------------o--------------------------------------------------------------------------
-------------------ooo-------o---------o----------------------ooo-----o---o------o--------o--------o---------------o------------------------
-----------oo---------o-o-------------o--oo--o-oo-o-o-------------o--o-oo----oooo-----oooo--o-----o-o--------------------o-o----------------
---------------------------XXSoo-o---------------o?S??o---------?X-oo------S-X------oo--------o------o----o-oo-o------oo--o-oo--------------
-------oooo------o-----o-o-----------------oo--???--------oooo--------??------------------?-XX---o----o-o-------oo------o-?SSS--------------
------o----X----o------------------o--------?S--------SSXX--------S-SX----------------X-?------------------?--o---------S?------------------
------S???--------------------XSS-----------------------------------------------------------------------------------------------------------
------------------XXXX----XXXX--------XXXX--------XXXX--------XXXX--------XXXX------------------------------------------------XXXX----------
------------------XXXX----XXXX--------XXXX----XXXXXXXX--------XXXX----XXXXXXXXXXXX--------XXXX----XXXX------------XXXX----XXXXXXXXXXXXXXXXXX
XXXXXX----XXXX----XXXXXXXXXXXX--------XXXXXXXXXXXXXXXXXXXX----XXXXXXXXXXXXXXXXXXXXXXXXXXXXXXXXXXXXXXXXXXXXXXXX----XXXXXXXXXXXXXXXXXXXXXXXXXX
