--------------------------------------------------------------------------------------------------------------------------------------------
--------------------------------------------------------------------------------------------------------------------------------------------
--------------------------------------------------------------------------------------------------------------------------------------------
--------------------------------------------------------------------------------------------------------------------------------------------
-------------------ooo---o------------oo------o------------------------------o--------------------------------------------------------------
------------------o---o-----------------o-----------------oo----------o--oo-o-------o-----o-----------------------o--oo------o--------------
---------ooo------------------o-o----------------o------o---o----------o---o---------o------o------oo--------ooo-o--o---o-------------------
-------o----o---o--------S---------o-o----o--o??--o------o---oo-o-oo----o--?----oo-----o--??X--oo-o-------------o------o--------------------
--------o-?S??-----------------o-------------------oooS?------------ooX?XX-----o----??--oo----o------o----?SS?----------?-S?----------------
---------------------------o-o-X?S----------------?--------------S------------o-------o-------??---------o----------------------------------
--------------------------?X?-------------------------------------?-??-----------------?S?-------------?SS----------------------------------
------------------XXXXXXXX------------XXXX----XXXX------------------------XXXX------------XXXX--------------------XXXX----------------------
----------XXXX----XXXXXXXX------------XXXX----XXXX----XXXXXXXX--------XXXXXXXX----XXXX----XXXX------------XXXXXXXXXXXXXXXXXXXXXXXX----------
XXXXXXXXXXXXXX----XXXXXXXX----XXXX----XXXXXXXXXXXXXXXXXXXXXXXXXXXX----XXXXXXXX----XXXX----XXXXXXXXXXXX----XXXXXXXXXXXXXXXXXXXXXXXXXXXXXXXXXX
