--------------------------------------------------------------------------------------------------------------------------------------------
--------------------------------------------------------------------------------------------------------------------------------------------
--------------------------------------------------------------------------------------------------------------------------------------------
--------------------------------------------------------------------------------------------------------------------------------------------
-------o------------------o-o---o--------------------------oo---------------------------------------------------------o-oo------------------
--------------------ooo-------oo--------------------------o--------ooo--------o----------o-----------o--------o--------o--o-----------------
------o-oo--oo----oo----oo---o---o---------------o-------o---o-ooo-------------o----oo--o----------oo-o----o---o----------------------------
------?--?o------o------????-X??X-o-------o----oo--o-------X---------------------o-o---o--o----o---------o--oo---o--o----S-ooo--------------
-----------o-----------------------o-oo-o---o-o---o---S???--------S?-?o----oo-----o---X?XS-------------o--o---?--?--------?S?---------------
----------S?S-----------------------o--o-o---o-XS?---------------X-----o--o----------S----???--------------??-------------------------------
--------------------------------------------------S??S----------------?XSSSXS---------------------------------------------------------------
XXXXXXXXXX--------XXXXXXXXXXXXXXXX------------------------XXXX------------------------------------XXXX----------------XXXX------------------
XXXXXXXXXX--------XXXXXXXXXXXXXXXX--------------------XXXXXXXX----XXXX--------XXXX----XXXX--------XXXX--------XXXX----XXXXXXXX--------------
XXXXXXXXXXXXXX----XXXXXXXXXXXXXXXX------------XXXX----XXXXXXXXXXXXXXXX--------XXXXXXXXXXXXXXXXXXXXXXXXXXXXXXXXXXXX----XXXXXXXXXXXX--XXXXXXXX
