--------------------------------------------------------------------------------------------------------------------------------------------
--------------------------------------------------------------------------------------------------------------------------------------------
--------------------------------------------------------------------------------------------------------------------------------------------
--------------------------------------------------------------------------------------------------------------------------------------------
------------------------------oo-o----oo--------------------------------------------------oo-o----------------------------------------------
------------o-----o--o----------o-------oo------------------------------------ooo-----------------------------------o-----------------------
----------oo-----------------------oo-----------o--------ooo----------o-----------o-o-o---------oo----o--o----------------------------------
---------oS-?----------------oS??---------o--o-o-o----o-o---o---o-o--------o-----------o-o-SS----------------o-ooo-o-oo------o--------------
----------------o-------X-S-XX-----?-------------------------o-----o-----o--------------o-----S?XXo-o-------o----------o-o------------------
--------o------o---------------------------o--???--o-o?--------o-o---oSSXX---o-------S???----------o-o-----o--o---------o-?-??--------------
------?XSS----?----------------------------X??----X?-?------------?S-----------------------------------------X?-?--------X------------------
XXXXXX----XXXX----------------XXXX----XXXX------------------------------------XXXX--------XXXX----------------------------------------------
XXXXXX----XXXX----XXXXXXXXXXXXXXXXXXXXXXXX------------------------------------XXXX--------XXXXXXXX----XXXX--------XXXX------------XXXXXXXXXX
XXXXXX----XXXX----XXXXXXXXXXXXXXXXXXXXXXXX----XXXX----XXXXXXXX--------XXXX----XXXXXXXXXXXXXXXXXXXX----XXXX--------XXXX----XXXXXXXXXXXXXXXXXX
