--------------------------------------------------------------------------------------------------------------------------------------------
--------------------------------------------------------------------------------------------------------------------------------------------
--------------------------------------------------------------------------------------------------------------------------------------------
--------------------------------------------------------------------------------------------------------------------------------------------
--------------------------o-------------------o-o----------------------o-----------o--------------------------oo----------------------------
-------------------o-o------oo-------o---------------------o-------------------o--o-o---------o-o---------------o-----o--o------------------
---------o-----o-oo--------o-----o-o------o------o-o-oo-----o---o--o--o-o-o-o-o-o----o--o-oo-----o--------o------o--o---o-------------------
--------------------o----o?XS?-o--SS---o------XX?S-------o--------S?????-?---------------o--o------o----------SXX?-o---o----oo--------------
-------SS?-oooo--------o------o-------------oo----o-o---------------------X?--XX-------------o----o-o--------o-------o--?Soo----------------
----------??SXS-------o-------SSSX----o-oo--------??X---------XXX?-----------------------?X?-?------------?X?X------------XX?---------------
-------------------------X------------------------------------------------------------------------------------------------------------------
--------------------------XXXX----XXXX--------XXXX--------XXXX----XXXXXXXX--------XXXX--------XXXX----XXXX----XXXX----------------XXXXXXXXXX
XXXXXXXXXX--------XXXX----XXXX----XXXX--------XXXX----XXXXXXXX----XXXXXXXXXXXXXXXXXXXX--------XXXX----XXXX----XXXX----XXXX----XXXXXXXXXXXXXX
XXXXXXXXXXXXXXXXXXXXXX----XXXXXXXXXXXX----XXXXXXXXXXXXXXXXXXXXXXXXXXXXXXXXXXXXXXXXXXXXXXXXXXXXXXXXXXXXXXXXXXXXXXXXXXXXXXXXXXXXXXXXXXXXXXXXXX
