--------------------------------------------------------------------------------------------------------------------------------------------
--------------------------------------------------------------------------------------------------------------------------------------------
--------------------------------------------------------------------------------------------------------------------------------------------
--------------------------------------------------------------------------------------------------------------------------------------------
-------o-------------------------------o---o------------------oo-o-----o------------------oo-o---o------------------------------------------
--------oo------------o---------------------o---------o-----------------o-------o-------------------oo----------o------o--------------------
----------------o--o----------o-------o-oo---o--o-------o----------o--o-----oooo-o--o-------------oo-------o---o-----oo--o------------------
------?X---------oo--o---o---o-oo-------S--??-----o---------o---------???-------------------------------ooo-ooo--oo------S---o--------------
----------o---o----------So---SS?--o-----------o-o----S?--o----------o----o-------o---o-o------------------X--???----------oo---------------
-----------oo-?-?----------o---------o--------?X??-o-------o-o----S-SS-------------X-X-o-o---------------?---------?S------S?---------------
----------?-?X------------?SX?---------------------X----------------------------------SS?---------------------------------------------------
XXXXXXXXXX----------------------------XXXXXXXX----------------XXXX----XXXX----------------XXXXXXXXXXXX----------------XXXX------------------
XXXXXXXXXX--------XXXXXXXX----XXXX----XXXXXXXX--------XXXX----XXXX----XXXX----XXXX--------XXXXXXXXXXXX----XXXXXXXX----XXXX------------------
XXXXXXXXXX----XXXXXXXXXXXX----XXXX----XXXXXXXXXXXX----XXXX----XXXXXXXXXXXXXXXXXXXXXXXX----XXXXXXXXXXXXXXXXXXXXXXXXXXXXXXXXXXXXXXXXXXXXXXXXXX
