--------------------------------------------------------------------------------------------------------------------------------------------
--------------------------------------------------------------------------------------------------------------------------------------------
--------------------------------------------------------------------------------------------------------------------------------------------
--------------------------------------------------------------------------------------------------------------------------------------------
-------------------------------o-------------------------------------------o-o------------oo-o-------------------------o--------------------
------------------o--------o-----o-------------------------o--ooo---o-oooo--o-----o---------o-o--o--------o--oo-----------o-----------------
-------o---------o-ooooo--o-ooo-o-----oo-----o--oo-------o---------o-o---------------o------------------------------o-o-oo--oo--------------
--------oo-------------------X?-S?---o---------o---o------o-o-------------?---------S--oo--X-X------oo-o----o--oo-------SS------------------
----------oo--o-o-------------------o----oo-o-X??Xo----------------S-?S?-X------o--------o--------o----XSX?S?X-X?S--------?SS?--------------
-------???---o?S------------------????-------?------o-S-----------------------o--o----o------------o----------------------------------------
----------??-?------------------------------------S-S----------------------------------XX---------------------------------------------------
------------------XXXX----XXXXXXXX----------------------------XXXX--------XXXX----XXXX----XXXX--------------------XXXXXXXX----XXXX----------
------------------XXXX----XXXXXXXX------------XXXX--------XXXXXXXXXXXXXXXXXXXX----XXXX----XXXXXXXX----XXXXXXXXXXXXXXXXXXXXXXXXXXXXXXXXXXXXXX
XXXXXXXXXX----XXXXXXXXXXXXXXXXXXXXXXXXXXXXXXXXXXXX----XXXXXXXXXXXXXXXXXXXXXXXX----XXXX----XXXXXXXX----XXXXXXXXXXXXXXXXXXXXXXXXXXXXXXXXXXXXXX
