--------------------------------------------------------------------------------------------------------------------------------------------
--------------------------------------------------------------------------------------------------------------------------------------------
--------------------------------------------------------------------------------------------------------------------------------------------
--------------------------------------------------------------------------------------------------------------------------------------------
------------------o----------------------------------------o----------oo--------------------------------------------o-----------------------
---------------------o----o-------------------------------o-o------------o--------o---------------o---------o--------o----------------------
----------o--------oo--o---o---------o------------o------o---o-o-o--------o--oo-o-----o------o------oo-------o-o---o--o-o-------------------
--------o--o-----------------o-o-ooo---oo-------------------------o-o-?SX?-----o-o-o------o--------o-----o----o-----------------------------
----------??X----o----o-oo?S?S----S??-o--o-o---o-o--o---------o----o-o----?S------------oo--o--o-----------??----o-----o--------------------
-------??S----o-o------------------------------SX??X?S---------X??-------------?-------????-S?---o----o-----------------S?ooo---------------
--------------?----------------S?S--------------------------------??X--------------------------?-----------------------------X--------------
------------------XXXX------------------------------------XXXX--------XXXX----------------------------------------XXXX----------------------
----------XXXX----XXXX----XXXX----XXXX--------------------XXXX--------XXXXXXXX----XXXX------------XXXX----XXXX----XXXX------------XXXXXXXXXX
XXXXXXXXXXXXXX----XXXXXXXXXXXX----XXXX----XXXXXXXXXXXXXXXXXXXXXXXX----XXXXXXXXXXXXXXXXXXXXXXXX----XXXX----XXXXXXXXXXXXXXXX----XXXXXXXXXXXXXX
