--------------------------------------------------------------------------------------------------------------------------------------------
--------------------------------------------------------------------------------------------------------------------------------------------
--------------------------------------------------------------------------------------------------------------------------------------------
--------------------------------------------------------------------------------------------------------------------------------------------
-------------------o-------------------------------------------oo---o-----o--o-----o-o---o-------------------o------------------------------
-------o-o-------o------o------------------------------o-----o---oo---o-----o-------o-----ooo-------------oo--------------------------------
-----------o------o-o----o----------------------------o-o--o-------o-o---o--------------o--------o---o------o-o--o-o------------------------
--------o----o------------oooo----o---o-o--SSS--o----o------o-X-XXX?--SX--S---oo----?S?X-X----S?---o--o---SXXS------------------------------
--------??o-----------S---?X?-o-o---o---------??-?--o---------------------------oo--------??-S------o---------S?----------------------------
------------??----------------?XS-----------------o------------------------------------------------?------------------o-oo---o--------------
----------------------------------X-------------------------------------------------------------------------------------XXX-----------------
------------------XXXX--------------------XXXX--------XXXX----XXXXXXXXXXXXXXXX----XXXXXXXX----XXXX--------XXXX------------------------------
XXXXXXXXXX----XXXXXXXXXXXXXXXX------------XXXXXXXX----XXXXXXXXXXXXXXXXXXXXXXXX----XXXXXXXXXXXXXXXX--------XXXXXXXXXXXX----------------------
XXXXXXXXXXXXXXXXXXXXXXXXXXXXXXXXXX--------XXXXXXXX----XXXXXXXXXXXXXXXXXXXXXXXX----XXXXXXXXXXXXXXXXXXXX----XXXXXXXXXXXX------------XXXXXXXXXX
