--------------------------------------------------------------------------------------------------------------------------------------------
--------------------------------------------------------------------------------------------------------------------------------------------
--------------------------------------------------------------------------------------------------------------------------------------------
--------------------------------------------------------------------------------------------------------------------------------------------
-------------------------------------o--------------------ooo-------------------------------------------------o----------o------------------
------------------------------o-------ooo-------o--------o-------------o---------------------------o-oo--o-----o------oo--oo----------------
------o--------o-o-------------o---------o------------o------o-------oo-o------------------oo----oo----oo-------oo--------------------------
---------oooo-XX?---ooo--o--o---ooS--------o---o-o-o---o--S-------o-------oo---ooo-o----oo----------o------o--XX-X---o---S------------------
-------o--X-S--------------o-o????-------------?-?o---?SS-----------o--??-----o-------o---o--o--------------------o-o------?-?--------------
------X-??----------------o-------------------------o-----------XX?S??-------o------------?S?---------------oo------------------------------
---------------------------X----------------------X???--------------------S?----------??-X----------------?S?S------------------------------
--------------XXXX----------------XXXX--------------------XXXX----------------------------------------XXXX----XXXX----XXXX----XXXX----------
----------XXXXXXXXXXXX--------XXXXXXXXXXXX----XXXX----XXXXXXXX--------XXXX--------XXXX------------XXXXXXXX----XXXX----XXXXXXXXXXXX----------
XXXXXXXXXXXXXXXXXXXXXX--------XXXXXXXXXXXX----XXXX----XXXXXXXXXXXXXXXXXXXX----XXXXXXXX----XXXXXXXXXXXXXXXX----XXXXXXXXXXXXXXXXXXXXXXXXXXXXXX
