--------------------------------------------------------------------------------------------------------------------------------------------
--------------------------------------------------------------------------------------------------------------------------------------------
--------------------------------------------------------------------------------------------------------------------------------------------
--------------------------------------------------------------------------------------------------------------------------------------------
--------------------------o-o-------------o------------------------o-o--------------oo----------------------------o-o-----------------------
------------------------------ooo---o--------o-------------o------o------------------------------------ooo-o-----o---o-o-oo-----------------
--------------o---------oo-o-o----o--oo-oo----------------o------o------------o-------o------------o--o-----o-oo----------------------------
------o---o---------oooo--X-S----o--------------o---o---o---ooo-----?-----o----oo-------ooo---------o--------o----------o---o---------------
-------o-o-o------oo-----S----X??XS----o---------oo---o--------X------ooo---o----o------------?X-----o----X?--?---------X?-S??--------------
--------o-----------------------------------------X?---o--------------X??X-o-----------???---o----------------------------------------------
------X??-?XSX--------------------------------?X-X----X--?----------------SSX-------------??-S----------------------------------------------
XXXXXX--------XXXX--------XXXX------------XXXX--------------------XXXX------------XXXX----------------------------XXXX----------------------
XXXXXX--------XXXX----XXXXXXXXXXXXXXXX----XXXX------------XXXXXXXXXXXX------------XXXX--------XXXX----XXXXXXXXXXXXXXXXXXXXXXXX------XXXXXXXX
XXXXXX--------XXXX----XXXXXXXXXXXXXXXXXXXXXXXX----XXXX----XXXXXXXXXXXXXXXX----XXXXXXXXXXXX----XXXXXXXXXXXXXXXXXXXXXXXXXXXXXXXX------XXXXXXXX
