--------------------------------------------------------------------------------------------------------------------------------------------
--------------------------------------------------------------------------------------------------------------------------------------------
--------------------------------------------------------------------------------------------------------------------------------------------
--------------------------------------------------------------------------------------------------------------------------------------------
--------------------------------------o-oo------------------------------------------------o-o------o----------------------o-----------------
--------o--------------------------------------------------oo-----oo-o------------------o------------------oo---------o---------------------
---------o-------o---------------------o-------o-o---o----o----o----o----------ooo-----o-------o--o-oo-oo----o-------o-o-o-o----------------
---------------oo-ooo-o-o---------XS----------------o--oo----o-XS?-X?S--------------o----oSS?X------------------o--oo---o---S---------------
------?XX?-oo-?-----------o--ooooo---------o--o-o-o-------------------ooo-oo-o----o----???-------o---------??------------?------------------
----------o--o--------------o----------------o-X?S--SS-XX-----------------S-------------------?---------------oo-o--------------------------
----------?S??-------------?-SS-?S------------------------------------XX??------------------------------------??S?--------------------------
----------------------------------XXXXXXXX--------------------XXXXXXXX--------------------XXXX----XXXX--------------------XXXX------XXXXXXXX
XXXXXXXXXX----XXXX----------------XXXXXXXX----------------XXXXXXXXXXXX----------------XXXXXXXX----XXXX----XXXX--------XXXXXXXX------XXXXXXXX
XXXXXXXXXX----XXXXXXXX------------XXXXXXXX----XXXXXXXXXXXXXXXXXXXXXXXX----XXXXXXXX----XXXXXXXXXXXXXXXXXXXXXXXX----XXXXXXXXXXXX------XXXXXXXX
