--------------------------------------------------------------------------------------------------------------------------------------------
--------------------------------------------------------------------------------------------------------------------------------------------
--------------------------------------------------------------------------------------------------------------------------------------------
--------------------------------------------------------------------------------------------------------------------------------------------
------------------------------o-----------------------------------------------------------------------o-------o--o--------------------------
------------o---------o--------o-----------o-o-----------o----o---------o---o-------o---o----------------------o--o----------o--------------
-------------------------o--------o----o-o--------o---o---------o-----o---oo-o-----------o---o----ooo-------------------o-------------------
--------oooo------oo-----------???--o---o------ooo-o--------o------o-----o?------o--S??XXX--o-oo--------------??S----o---ooo----------------
----------X-S?oo-o---o---------------o----------X-----X----o----??---o???-----oo----------oo----------------o-----X---oo--X--?--------------
-------X-?------------------oo-----S--------------?S??-------o------o---------------------S??----o---------o-------------S------------------
--------------?--S----------X?------------------------------------S?SS------------------------------------?SXS------------------------------
----------------------XXXX----XXXX----------------------------------------XXXX----XXXXXXXX------------XXXX----XXXX--------------------------
----------XXXX--------XXXX----XXXX--------XXXXXXXX----XXXX----XXXX----XXXXXXXX----XXXXXXXX--------XXXXXXXX----XXXXXXXX----XXXX----XXXXXXXXXX
XXXXXXXXXXXXXX----XXXXXXXX----XXXXXXXXXXXXXXXXXXXXXXXXXXXX----XXXX----XXXXXXXX----XXXXXXXXXXXX----XXXXXXXX----XXXXXXXXXXXXXXXX----XXXXXXXXXX
