--------------------------------------------------------------------------------------------------------------------------------------------
--------------------------------------------------------------------------------------------------------------------------------------------
--------------------------------------------------------------------------------------------------------------------------------------------
--------------------------------------------------------------------------------------------------------------------------------------------
-------------------------o-o------------o-------------o---------------------------------------o-----o---oo----------------------------------
----------------------o------o----o---o-------------------oo----o---oo-------------------------oo--o-o-----o-o--------------o---------------
-------ooo--------------o---o-o--------o-o-------o-o----o---oo---o----o--o---oo-------o---o------o----o--------------------o----------------
------------o-o---o----?SX??X--o--?-------------o---o---------o-----------------o--------o---------------?o-o--o--------oo------------------
----------o--------o-o-------------------------o------------------?SSX-------------o---o---o--------------X?-Xo-o--o---o---S?X--------------
------X?S?-o---oo---o---------S??---------oo--SS??SS-------------------X?---------o---XXX?----------------------------o---------------------
-----------?XXS----------------------------SS?--------------------------------------??------------------------?X?-?-----S?------------------
----------------------XXXXXXXX----XXXXXXXX------------XXXX------------------------------------XXXXXXXXXXXX----------------------------------
----------------------XXXXXXXX----XXXXXXXX------------XXXXXXXXXXXXXXXX------------------------XXXXXXXXXXXXXXXX------------XXXX----XXXXXXXXXX
XXXXXXXXXX------------XXXXXXXXXXXXXXXXXXXX----XXXXXXXXXXXXXXXXXXXXXXXXXXXXXXXXXXXX----XXXXXXXXXXXXXXXXXXXXXXXX------------XXXX----XXXXXXXXXX
