--------------------------------------------------------------------------------------------------------------------------------------------
--------------------------------------------------------------------------------------------------------------------------------------------
--------------------------------------------------------------------------------------------------------------------------------------------
--------------------------------------------------------------------------------------------------------------------------------------------
-----------------------o-o----------------------------------o---------------------------------o--o----o-------------------------------------
----------oo---------o----o---oo----o---------------------oo------------------oo--o--o---------------------------------oo-------------------
-------------------o--------oo-------o-----------o------------------------------o--o--oo-o-----------------oo--------o---o------------------
-------o-o------o---o---??S?XX--------o-ooo----o---o--???--------------o-oo------o--------oo----------XS??--------o-o---X-o-----------------
--------o-??-----o-------------???-----------o------o---------o-------o-----o------S??--------------o-----o--oo------------oo---------------
-------------------------------------------oo--XS?o--o----------o--o-o--o-?-----------????--------oo-o----????---o--------------------------
------???S----------------------------------------??-?---------X----??SX?X--------------------------------------?----------X-S--------------
----------------------XXXXXXXX----XXXX----------------XXXXXXXX--------------------------------XXXX----XXXX------------XXXX------------------
XXXXXX----XXXX----XXXXXXXXXXXXXXXXXXXX----------------XXXXXXXX----------------XXXXXXXX----XXXXXXXX----XXXX--------XXXXXXXX------------------
XXXXXX----XXXXXXXXXXXXXXXXXXXXXXXXXXXX--------XXXX----XXXXXXXX------------XXXXXXXXXXXXXXXXXXXXXXXX----XXXXXXXX----XXXXXXXX----XXXX--XXXXXXXX
