--------------------------------------------------------------------------------------------------------------------------------------------
--------------------------------------------------------------------------------------------------------------------------------------------
--------------------------------------------------------------------------------------------------------------------------------------------
--------------------------------------------------------------------------------------------------------------------------------------------
------o--o----------------------------------------------o--------------oo-------------------------------------------------o-o---------------
--------o-------------o-----o-------------------o--o-o---o------------o-----------oo-o--------oo------o-----------o--o-----o----------------
-------o--o--o--oo--------o---o-o-----------------o---o-----o-------------o--o-----------------------o--------o-----------------------------
------SXX?--o-o--------o-----o---------o-ooo---o-o--o-----o----o---o-o------o---o--------o-o-oS----o------o------o------o-?-----------------
-----------------------??--?-S-o--o-ooo-o------S-X?--------o-o-------------o---------Xo-o-o-------o-o--?X?--oo-o---------o------------------
----------SX?-X??--oo---------S-XXS---------------------------------o----------o-o-----S??---------------------S?X-----o--------------------
---------------------------------------------------------------?SS??S?----------X---------?S?-------------X?S-----------S?------------------
XXXXXXXXXX--------------------------------------------XXXX------------XXXX--------------------XXXX------------------------XXXX--------------
XXXXXXXXXX------------XXXXXXXX----------------XXXXXXXXXXXX------------XXXX--------XXXX--------XXXX----XXXX--------XXXX----XXXX--------------
XXXXXXXXXXXXXXXXXX----XXXXXXXXXXXXXXXXXXXXXXXXXXXXXXXXXXXXXXXX--------XXXXXXXX----XXXXXXXX----XXXXXXXXXXXX----XXXXXXXX----XXXX----XXXXXXXXXX
