--------------------------------------------------------------------------------------------------------------------------------------------
--------------------------------------------------------------------------------------------------------------------------------------------
--------------------------------------------------------------------------------------------------------------------------------------------
--------------------------------------------------------------------------------------------------------------------------------------------
--------------------------------------------oo----oo-o----------------o--------------------------------o-------------o----------------------
--------------------------------------------------------------o--------o------------------o-o-----------o-o-o----------o-o------------------
----------o-----------o---------------oo--------------oo-----o---------------o---o------------o-o-----o----o------o-------------------------
-----------o-----o-o---------o-oo-----------X----oS?S------o----oo--o--X--o----o------------??-----o--S?XS---o-o-oS-----o--o-o--------------
------o--o--oo--o-o-o----?----o---o-----o-----o-------------o----?---o----------o-----oooo------------------S-o-o---------o-----------------
-----------X--o-------------o-XSX---------------------?SX----------o-----------------o--------S?--o-oo----------S?-----------S--------------
-------?-?-----------------S??----------------XS??----------------SX??-----------------?XS--------------------------------------------------
------------------------------------------XXXX----XXXX----------------XXXX----------------XXXX--------XXXX--------XXXX----------------------
----------------------XXXX----------------XXXX----XXXX--------XXXX----XXXX----------------XXXX--------XXXXXXXX----XXXXXXXX----XXXXXXXXXXXXXX
XXXXXX----XXXX----XXXXXXXX----XXXX----XXXXXXXX----XXXXXXXXXXXXXXXX----XXXXXXXXXXXX--------XXXXXXXX----XXXXXXXXXXXXXXXXXXXXXXXXXXXXXXXXXXXXXX
