--------------------------------------------------------------------------------------------------------------------------------------------
--------------------------------------------------------------------------------------------------------------------------------------------
--------------------------------------------------------------------------------------------------------------------------------------------
--------------------------------------------------------------------------------------------------------------------------------------------
--------------------------------oooo------------------oo-o----------------o---o-oo-o-o----------------o-------------------------------------
------------o---o-o-oo--------o-----o------------------------------o-o------------o------------ooo---------o-----o-------o-o-o--------------
----------o--o-o---------------o-----o-oo--------o------------o--o---------ooo-o------o--o-o--o--------------oo-----------o-----------------
----------S?X-------------o--oS--??S--------?-------o--??--oo---------o-------------X?-o--o-ooX-----oo----o----o------oo--------------------
------o-oo-------------oo---o---------o-------X??X-----------------X?S-ooo-----------------?SX----o-------?X-??-SX?S----X?---?--------------
------S-SS----------------------------------------S??-----o------------X?X------------????--------------------------------------------------
----------------------------X?--------------------------------------------------------------------------------------------------------------
----------XXXXXXXX------------XXXXXXXX----XXXX--------XXXX----------------XXXXXXXXXXXX--------XXXX----XXXX--------------------XXXX----------
----------XXXXXXXXXXXX--------XXXXXXXX----XXXXXXXX----XXXX----XXXXXXXX----XXXXXXXXXXXX----XXXXXXXX----XXXXXXXXXXXXXXXXXXXXXXXXXXXX----------
XXXXXXXXXXXXXXXXXXXXXX--------XXXXXXXXXXXXXXXXXXXXXXXXXXXX----XXXXXXXXXXXXXXXXXXXXXXXXXXXXXXXXXXXXXXXXXXXXXXXXXXXXXXXXXXXXXXXXXXXXXXXXXXXXXX
