--------------------------------------------------------------------------------------------------------------------------------------------
--------------------------------------------------------------------------------------------------------------------------------------------
--------------------------------------------------------------------------------------------------------------------------------------------
--------------------------------------------------------------------------------------------------------------------------------------------
-----------------o-----------------o-o--oooo---------o--------------------------------------------------------------------------------------
--------o-------o-------o-----------o---------o-o-o---------------o-o-------------o--o----------------o-o--o----o---------------------------
------o--ooo-------------o-------------o-----o-o--------------o------oo-----o-oo-o-----o----o----o--------o--oo------o----------------------
-------o------S?X-o-o-----------------------X?---o???---o-o-----o-X?-?--o--o-------------o----------oo---o--o----------o--o-----------------
------S??----------o-o---------o--------------?-?S----?----oo----S-----o--------o-----o-o-o--o----o-----XX-?-?-?--------o--oo---------------
----------????-------------oo-o-o-------------------------------------S????------------SS?SS-????-----------------------?-S?SX--------------
---------------------------SS-S?SS----------------------------------------------------------------------------------------------------------
--------------XXXX----XXXX--------XXXXXXXXXXXX----XXXX------------XXXX------------XXXX--------------------------------------------XXXXXXXXXX
XXXXXXXXXX----XXXX----XXXX--------XXXXXXXXXXXXXXXXXXXXXXXX----XXXXXXXX------------XXXX----------------XXXXXXXXXXXXXXXX------------XXXXXXXXXX
XXXXXXXXXXXXXXXXXX----XXXX--------XXXXXXXXXXXXXXXXXXXXXXXXXXXXXXXXXXXXXXXXXXXXXXXXXXXXXXXXXXXXXXXXXXXXXXXXXXXXXXXXXXXXXXXXXXXXXXXXXXXXXXXXXX
