--------------------------------------------------------------------------------------------------------------------------------------------
--------------------------------------------------------------------------------------------------------------------------------------------
--------------------------------------------------------------------------------------------------------------------------------------------
--------------------------------------------------------------------------------------------------------------------------------------------
----------------ooo--------ooo---------------------ooo------------------------o-----------------o-------------------------------------------
---------------o----oo----o---------o--o----------o-------------o--------o-------------------------oo-o--o--o--o-o--------o-o---------------
-----------o-------o-----o-----------o--o------oo------------------------------ooo--o----------------o----o--oo---oo---o---o-o--------------
-------o--o-oo?-----------????----S-?X------o-----?S?X--oo-o-o------o-oo---o-----S----o-----------o-------------o-----o-oo------------------
--------oo?S?----------o--------o----------------o------------S--S-o-o?-----------?-X?-----o---------------X-??XS-----------X---------------
------------------------------o-----------o--o-?S?-----o--o-o---------------------------ooo-oo--------------------------?S------------------
------X???---------------------?S?--------------------X?-----S----X??S-----------------S??S?------------------------------------------------
--------------XXXXXXXX----XXXX----XXXXXXXX--------XXXX------------------------XXXX------------XXXX----XXXX----------------------------------
XXXXXX----XXXXXXXXXXXX----XXXX----XXXXXXXX--------XXXX--------XXXX----XXXX----XXXXXXXX--------XXXXXXXXXXXXXXXXXXXX--------XXXXXXXXXXXXXXXXXX
XXXXXX----XXXXXXXXXXXXXXXXXXXX----XXXXXXXX----XXXXXXXX--------XXXX----XXXXXXXXXXXXXXXX--------XXXXXXXXXXXXXXXXXXXXXXXXXXXXXXXXXXXXXXXXXXXXXX
