--------------------------------------------------------------------------------------------------------------------------------------------
--------------------------------------------------------------------------------------------------------------------------------------------
--------------------------------------------------------------------------------------------------------------------------------------------
--------------------------------------------------------------------------------------------------------------------------------------------
--------------------------------------------------------o-----------------------------o-----------------------------------------------------
-----------------o------------o--------o--o---------------------------------------------o---------------------------------------------------
-----------o---------------------------------o------o-o-------------oo-----------------o-oo-------o-o---------------------------------------
----------o---o---------o--o---o-o---oo-o------o-ooo------oo----o-o-----------oo----oo--?X-----o---o-o------ooo-o--oo-o----o-o--------------
--------o---oo----o--o--------??X-o-----------o-------------oo------------o--o--oo-o------?S-X---o--------??-S-------o-oo-o-----------------
------o--oX??------oo-o--o---o-----X-----------?S??S----------o---XSX?ooo--X--------------------o--------------o------------o---------------
------?S?--------------?-?-X-X----------------------------------XX----S-X---------------------?-S-------------X?--------?S--XX--------------
------------------------------------------------------XXXX----------------------------XXXX--------------------------------------------------
--------------XXXX------------XXXX----XXXXXXXX--------XXXX----------------------------XXXXXXXX------------XXXX------------------------------
XXXXXX----XXXXXXXX------------XXXXXXXXXXXXXXXXXXXXXXXXXXXXXXXX----XXXX----XXXXXXXXXXXXXXXXXXXX----XXXX----XXXX----XXXX------------XXXXXXXXXX
