--------------------------------------------------------------------------------------------------------------------------------------------
--------------------------------------------------------------------------------------------------------------------------------------------
--------------------------------------------------------------------------------------------------------------------------------------------
--------------------------------------------------------------------------------------------------------------------------------------------
-----------------------------o---------------------------o----o-o----------------------------------o-----o---------oo-o-o-------------------
----------------------------o-------------------------o----oo---------------o---------------------o-o---o---------o----o--o-----------------
----------o--------oo------o----o--o---------------o------o---------------o----o-o------------o------o-o----o---------------o---------------
------------ooo--o--------??-S----------o---o----oo-o--?X-------?So----oo----o--o--------o----------------o--o---o------S----o--------------
-------oo--o--?---o--o--------oo--S?S-oo--o----oo-S?-X-------------oo---------------S-o-------X?-------------X--o------------?--------------
---------oS-XX----------------S?S------------------------------------o??X--------------SXS-oo------------------o----------------------------
-------XS?----------------------------------?-?SX------------------X-S--------------------??-?----------------?-S---------------------------
--------------------------XXXX------------------------XXXXXXXXXXXX--------------------------------XXXXXXXX--------XXXXXXXX--------XXXXXXXXXX
--------------XXXX--------XXXX----XXXX------------XXXXXXXXXXXXXXXX--------XXXX----XXXX--------XXXXXXXXXXXXXXXX----XXXXXXXXXXXX----XXXXXXXXXX
XXXXXX----XXXXXXXXXXXX----XXXXXXXXXXXXXXXX--------XXXXXXXXXXXXXXXX----XXXXXXXXXXXXXXXXXXXX----XXXXXXXXXXXXXXXX----XXXXXXXXXXXXXXXXXXXXXXXXXX
