--------------------------------------------------------------------------------------------------------------------------------------------
--------------------------------------------------------------------------------------------------------------------------------------------
--------------------------------------------------------------------------------------------------------------------------------------------
--------------------------------------------------------------------------------------------------------------------------------------------
------------------------------------------------------oo---------------------------------o--------------------------------------------------
----------o---------------------------------------o--o------o-----------------------o-oo--------o-o-o-oo------------------------------------
--------oo-o------oo-o-------o----------oo---------oo-----o--o------ooo--o-----------o--o--o-oo------o-----o-------------o------------------
--------------------o----o?S??oo----o--o----o---oo????-----o-------o--X??------o--oo----X?--o------o------o--o-------o----oo----------------
------o---X??---o------o-------------oo---oo---o------------------?SSX----o-----o----?----o----------??X-X-S??---o-----o----oo--------------
------S-?X------------o----------o??-------S--o-------------------------------o--o--------S??------------------o--------S-------------------
--------------?-XX-------?-----???------------??-?-------------------------------------------------------------?----------?X----------------
--------------------------XXXX--------------------XXXXXXXX------------XXXX------------XXXX--------------------------------------------------
----------XXXX------------XXXX--------------------XXXXXXXXXXXX----XXXXXXXX--------XXXXXXXX----XXXXXXXXXXXXXXXX------------------------------
XXXXXXXXXXXXXX----XXXX----XXXX----XXXXXXXXXXXX----XXXXXXXXXXXXXXXXXXXXXXXXXXXX----XXXXXXXXXXXXXXXXXXXXXXXXXXXX----XXXXXXXX----XXXX--XXXXXXXX
